3DIM	International Conference on 3-D Digital Imaging and Modeling	29	B1
3DUI	IEEE Symposium on 3D User Interfaces	18	B2
3PGCIC	International Conference on P2P, Parallel, Grid, Cloud, and Internet Computing	4	B4
AAAI	Conference on Artificial Intelligence	93	A1
AAECC	Applied algebra, Algebraic algorithms, and Error Correcting Codes	17	B2
AAIM	Algorithmic Applications in Management	14	B3
AAIP	Workshop on Approaches and Applications of Inductive Programming	3	B5
AAMAS	International Joint Conference on Autonomous Agents and Multiagents Systems	84	A1
ABiALS	Anticipatory Behavior in Adaptive Learning Systems	14	B3
ABS	Agent-based Simulation Workshop	5	B4
ABZ	Abstract State Machines, Alloy, B and Z	18	B2
AC	IADIS International Conference on Applied Computing	9	B4
ACC	American Control Conference	76	A1
ACE	Australasian Conference on Computing Education	21	B2
ACE_A	International Conference on Advances in Computer Entertainment Technology	30	B1
ACHI	International Conference on Advances in Computer-Human Interaction	11	B3
ACiD	Algorithms and Complexity in Durham	6	B4
ACII	International Conference on Affective Computing and Intelligent Interaction	24	B1
ACIIDS	Asian Conference on Intelligent Information and Database Systems	7	B4
ACIL	Advances in Computational Intelligence and Learning	9	B4
ACIS-ICIS	International Conference on Computer and Information Science	15	B3
ACIVS	Advanced Concepts for Intelligent Vision Systems Conference	18	B2
ACL	International Conference of the Association of Computational Linguistics	110	A1
ACL2	Workshop on the ACL2 Theorem Prover and Its Applications	12	B3
ACMC	Australasian Computer Music Conference	9	B4
ACNS	International Conference on Applied Cryptography and Network Security	34	B1
ACOM	International Workshop on Assessment of Contemporary Modularization Techniques	3	B5
ACRI	International Conference on Cellular Automata for Research and Industry	20	B2
ACSAC	Annual Computer Security Applications Conference	63	A1
ACSD	International Conference on Application of Concurrency to System Design	23	B1
Ada-Europe	International Conference on Reliable Software Technologies	18	B2
ADBIS	Symposium on Advances in Database and Information Systems	24	B1
ADC	Australasian Database Conference	32	B1
AdCom	International Conference on Advanced Computing and Communications	12	B3
ADHOC-NOW	International Conference on AD-HOC Networks and Wireless	22	B1
ADHOCNETS	International Conference on Ad Hoc Networks	2	B5
ADMA	International Conference on Advanced Data Mining and Applications	18	B2
ADMI	International Workshop on Agents and Data Mining Interaction	3	B5
ADPRL	IEEE International Symposium on Approximate Dynamic Programming and Reinforcement Learning	13	B3
ADS	Agent-Directed Simulation Symposium	3	B5
ADT	Algorithmic Decision Theory	7	B4
AEM	International Conference on Applied and Engineering Mathematics	6	B4
AES-Brasil	Audio Engineering Society - Brasil	2	B5
AFRICACRYPT	International Conference on Cryptology in Africa	15	B3
AGI	Artificial General Intelligence	9	B4
Agile	Agile Development Conference	26	B1
AGILE_A	AGILE Conference on Geographic Information Science	10	B3
AGO	International Conference on Advances In Global Optimization: Methods and Applications	2	B5
AGS	Agents for Games and Simulations	6	B4
AI	Canadian Conference on Artificial Intelligence	24	B1
AI*IA	Congress of the Italian Association for Artificial Intelligence	15	B3
AIA	Artificial Intelligence and Applications Conference	6	B4
AIAI	IFIP International Conference on Artificial Intelligence Applications and Innovations	10	B4
AICCSA	ACS/IEEE International Conference on Computer Systems and Applications	23	B1
AICT	Advanced International Conference on Telecommunications	22	B1
AIED	International Conference on Artificial Intelligence in Education	29	B1
AIED_A	Workshop on Motivation and Affect in Educational Software	3	B5
AIIDE	Artificial Intelligence and Interactive Digital Entertainment	19	B2
AIME	Conference on Artificial Intelligence in Medicine in Europe	19	B2
AiML	Advances in Modal Logic	15	B3
AIMS	Autonomous Infrastructure, Management and Security	9	B4
AIMSA	Artificial Intelligence: Methodology, Systems, Applications	16	B2
AINA	International Conference on Advanced Information Networking and Applications	39	A2
AIRS	Asia Information Retrieval Symposium	14	B3
AIS	SIGED International Conference on Informatics Education and Research	2	B5
AISAT	International Conference on Artificial Intelligence in Science and Technology	2	B5
AISC	International Conference on Artificial Intelligence and Symbolic Computing	13	B3
AISec	AI & Security Workshop	9	B4
AISM	Australian Information Security Management Conference	8	B4
ALAMAS	European Symposium on Adaptive Learning Agents and Multi-Agent Systems	3	B5
ALENEX	Workshop on Algorithm Engineering and Experiments	27	B1
ALG	Workshop on Algorithm Engineering	22	B1
AlgOR	International conference on Algorithmic Operations Research and Operations Research Case Competition	8	B4
ALGOSENSORS	Algorithmic Aspects of Wireless Sensor Networks	15	B3
ALIFE	IEEE Symposium on Artificial Life	6	B4
ALIFE_A	International Conference on the Simulation and Synthesis of Living Systems	19	B2
ALIO/EURO	Conference on Combinatorial Optimization	3	B5
ALPIT	International Conference on Advanced Language Processing and Web Information Technology	7	B4
ALT	International Conferences on Algorithmic Learning Theory	24	B1
ALTA	Australasian Language Technology Association Workshop	5	B4
AMAI	International Symposium on Artificial Intelligence and Mathematics	15	B3
AMAS-BT	Workshop on Architectural and Microarchitectural Support for Binary Translation	1	B5
AMAST	International Conference on Algebraic Methodology and Software Technology	27	B1
AMCIS	Americas Conference on Information Systems	32	B1
AMCS	International Conference on Algorithmic Mathematics and Computer Science	2	B5
AMIA	AMIA Annual Symposium	39	A2
AMINING	Active Mining	6	B4
AMS	Autonome Mobile Systeme	9	B4
AMSTA	Agent and Multi-Agent Systems: Technologies and Applications	13	B3
AMTA	Conference of the Association for Machine Translation in the Americas	4	B4
AMW	Alberto Mendelzon International Workshop on Foundations of Data Management	5	B4
ANALCO	Workshop on Analytic Algorithms and Combinatorics	8	B4
ANCS	Symposium On Architecture For Networking And Communications Systems	25	B1
ANDESCON	IEEE Andean Region International Conference	4	B4
ANIREM	Workshop on Agents Norms and Institutions for Regulated Multiagent Systems	1	B5
ANNPR	IAPR International Workshop on Artificial Neural Networks in Pattern	8	B4
ANPPOM	Congresso da Associação Nacional de Pesquisa e Pós-Graduação em Música	1	B5
ANSS	Annual Simulation Symposium	28	B1
ANTS	International Symposium on Algorithmic Number Theory	27	B1
ANTS_A	International Workshop on Ant Colony Optimization and Swarm Intelligence	10	B4
ANTS_C	International Symposium on Advanced Networks and Telecommunication Systems	6	B4
AOIS	Agent-Oriented Information Systems Workshop	8	B3
AOM	Aspect-Oriented Modeling Workshop	19	B2
AOSD	International Conference on Aspect-Oriented Software Development	55	A1
AOSE	Workshop on Agent-Oriented Software Engineering	7	B3
APCIP	Asia-Pacific Conference on Information Processing	6	B4
APEID	UNESCO-APEID International Conference	3	B5
APGV	Symposium on Applied Perception in Graphics and Visualization	19	B2
APLAS	Asian Symposium on Programming Languages and Systems	28	B1
APPROX	International Workshop on Approximation Algorithms for Combinatorial Optimization Problems	31	B1
APSCC	IEEE Asia-Pacific Services Computing Conference	15	B3
APTC	Asia-Pacific Trusted Infrastructure Technologies Conference	1	B5
APWEB	International Asia-Pacific Web Conference	20	B2
ARC	International Workshop on Applied Reconfigurable Computing	14	B3
ARCS	Architecture of Computing Systems	17	B2
ARES	International Conference on Availability: Reliability and Security	27	B1
ArgMas	International Workshop on Argumentation in Multi-Agent Systems	5	B4
ARM	Workshop on Adaptive and Reflective Middleware	7	B4
ArtAbilitation	The ArtAbilitation Conference	2	B5
ARVLSI	Conference on Advanced Research in VLSI	9	B4
ASAMA	International Symposium on Agent Systems and Applications / International Symposium on Mobile Agents	24	B1
ASAP	IEEE International Conference on Application-specific Systems: Architectures and Processors	29	B1
ASE	IEEE/ACM International Conference on Automated Software Engineering	55	A1
ASIACCS	ASIAN ACM Symposium on Information, Computer and Communications Security	32	B1
ASIACRYPT	International Conference on the Theory and Application of Cryptology and Information Security	69	A1
ASID	International Workshop on Anti-counterfeiting, Security and Identification	6	B4
ASIS&T	Annual Conference of the American Society for Information Science and Technology	5	B4
ASONAM	International Conference on Advances in Social Network Analysis and Mining	10	B4
ASP-DAC	Asia and South Pacific Design Automation Conference	48	A2
ASPLOS	International Conference on Architectural Support for Programming Languages and Operating Systems	72	A1
ASRU	IEEE Workshop on Automatic Speech Recognition & Understanding	20	B2
ASSETS	International ACM SIGACCESS Conference on Computers and Accessibility	38	A2
AST	Automation of Software Test	14	B3
ASYNC	Symposium on Asynchronous Circuits and Systems	37	A2
ATMOS	Workshop on Algorithmic Approaches for Transportation Modeling, Optimization, and Systems	8	B4
ATT	Workshop on Agents in Traffic and Transportation	4	B4
ATVA	Automated Technology for Verification and Analysis	22	B1
AUTOMATA	Cellular Automata Theory and Applicatins	6	B4
AVBPA	International Conference on Audio- and Video-Based Biometric Person	45	A2
AVI	International Working Conference on Advanced Visual Interfaces	38	A2
AWIC	Atlantic Web Intelligence Conference	16	B2
BAIP	International Conference on Recent Trends in Business Administration and Information Processing	4	B4
BASYS	IEEE/IFIP International Conference on Information Technology for Balanced Automation Systems	10	B4
BC	IFIP International Conference on Broadband Communications	3	B4
BCB	ACM International Conference on Bioinformatics and Computational Biology	5	B4
BCS-HCI	Conference of the British Computer Society Human Computer Interaction Specialist Group	6	B4
BDIM	IEEE/IFIP International Workshop on Business-Driven IT Management	9	B4
BEA	Workshop on the Innovative Use of NLP for Building Educational Applications	9	B4
BIBE	IEEE International Symposium on Bioinformatics and Bioengineering	27	B1
BIBM	IEEE International Conference on Bioinformatics and Biomedicine	9	B4
BIBMW	IEEE International Conference on Bioinformatics and Biomedicine Workshop	6	B4
BICA	Annual International Conference on Biologically Inspired Cognitive Architectures	4	B4
BICS	Brain-Inspired Cognitive Systems Conference	6	B4
BIOCOMP	International Conference on Bioinformatics and Computational Biology	8	B4
BIODEVICES	International Conference on Biomedical Electronics and Devices	6	B4
BIOINFORMATICS	International Conference on Bioinformatics Models, Methods and Algorithms	3	B5
BIOSIGNALS	International Conference on Bio-inspired Systems and Signal Processing	7	B4
BIOTECHNO	International Conference on Bioinformatics, Biocomputational Systems and Biotechnologies	3	B5
BIR	International Conference on Perspectives in Business Informatics Research	4	B4
BIRTE	International Workshop on Business Intelligence for the Real Time Enterprise	1	B5
BIS	International Conference on Business Information Systems	20	B2
BLISS	Bio-inspired, Learning, and Intelligent Systems for Security	7	B4
BMEI	International Conference on BioMedical Engineering and Informatics	7	B4
BMVC	British Machine Vision Conference	48	A2
BNCOD	Workshops of the British National Conference on Databases	18	B2
BPM	International Conference in Business Process Management	49	A2
BPMDS	International Conference on Business Process Modeling, Development, and Support	13	B3
BPMN	International Workshop on Business Process Modeling Notation	3	B5
BPSC	Business Process and Services Computing	8	B4
Broadnets	International Conference on Broadband Communications Networks and Systems	30	B1
BSB	Brazilian Symposium on Bioinformatics	7	B4
BTAS	IEEE International Conference on Biometrics: Theory, Applications and Systems	20	B2
BUCC	Workshop on Building and Using Comparable Corpora	2	B5
BWSS	Brazilian Workshop on Social Simulation	3	B5
C&T	International Conference on Communities and Technologies	3	B5
C5	International Conference on Creating Connecting and Collaborating through Computing	13	B3
CADE	International Conference on Automated Deduction	41	A2
CAGD	International Symposium of Computer Aided Geometric Design	52	A2
CAIA	Conference on Artificial Intelligence for Applications	1	B5
CAINE	ISCA International Conference on Computer Applications in Industry and Engineering	9	B4
CAIP	International Conference on Computer Analysis of Images and Patterns	20	B2
CAiSE	International Conference on Advanced Information Systems Engineering	51	A2
CAMAD	IEEE Workshop on Computer-Aided Modeling Analysis and Design of Communication Links and Networks	7	B4
CAMP	International Workshop on Computer Architectures for Machine Perception	14	B3
CANPC	Workshop on Communication Architecture and Applications for Network-Based Parallel Computing	6	B4
CAOS	Workshop on Computer Architecture and Operating System co-design	1	B5
CASA	Computer Animation and Social Agents	13	B3
CASCON	Annual International Conference on Computer Science and Software Engineering	30	B1
CASES	International Conference on Compilers, Architecture, and Synthesis for Embedded Systems	44	A2
CASE_A	IEEE Conference on Automation Science and Engineering	28	B1
CASON	International Conference on Computational Aspects of Social Networks	5	B4
CATA	International Conference on Computers and their Applications	11	B3
CATCH	Cybersecurity Applications & Technology Conference For Homeland Security	9	B4
CATE	IASTED International Conference on Computers and Advanced Technology in Education	9	B4
CAV	International Conference on Computer Aided Verification	82	A1
CBA	Congresso Brasileiro de Automática	5	B4
CBEE	Congresso Brasileiro de Educação Especial	1	B5
CBIC	Congresso Brasileiro de Inteligência Computacional	1	B5
CBIS	Congresso Brasileiro de Informática em Saúde	6	B4
CBMI	International Workshop on Content-Based Multimedia Indexing	12	B3
CBMS	IEEE Symposium on Computer-Based Medical Systems	26	B1
CBSE	International Symposium Component-Based Software Engineering	25	B1
CC	International Conference on Compiler Construction	38	A2
CCA	IEEE International Conference on Control Applications	6	B3
CCA_A	International Conference on Computability and Complexity in Analysis	13	B3
CCC	IEEE Conference on Computational Complexity	36	B1
CCCG	Canadian Conference on Computational Geometry	19	B2
CCCT	International Conference on Computer, Communication and Control Technologies	5	B4
CCC_A	Colombian Computing Congress	2	B5
CCGrid	IEEE/ACM International Symposium on Cluster Computing and the Grid	60	A1
CCNC	IEEE Consumer Communications and Networking Conference	31	B1
CCO	International Conference on Cooperative Control and Optimization	6	B4
CCRTS	International Command and Control Research and Technology Symposium	6	B4
CCS	ACM Conference on Computer and Communications Security	100	A1
CCW	IEEE Annual Computer Communications Workshop	5	B3
CC_A	Creativity and Cognition Conference	2	B5
CDC	IEEE Conference on Decision and Control	30	B1
CDVE	Cooperative Design, Visualization and Engineering	10	B4
CEA	International Conference on Computer Engineering and Applications	8	B4
CEAS	International Conference on Email and Anti-Spam	36	B1
CEC	IEEE Conference on Commerce and Enterprise Computing	27	B1
CEC_A	IEEE Congress on Evolutionary Computation	34	A2
CELDA	Cognition and Exploratory Learning in Digital Age	10	B4
CENTERIS	International Conference on Enterprise Information Systems	3	B3
CERMA	Robotics and Automotive Mechanics Conference Electronics	9	B4
CETS	Conference on E-business Technology and Strategy	2	B5
CF	ACM International Conference on Computing Frontiers	27	B1
CGI	Computer Graphics International Conference	31	B1
CGIM	International Conference on Computer Graphics and Imaging	9	B4
CGIV	International Conference on Computer Graphics, Imaging and Visualization	15	B3
CGO	IEEE/ACM International Symposium on Code Generation and Optimization	41	A2
CHARME	Conference on Correct Hardware Design and Verification Methods	25	B1
CHES	Workshop on Cryptographic Hardware and Embedded Systems	65	A1
CHI	Conference on Human Factors in Computing Systems	147	A1
CIA	International Workshop on Cooperative Information Agents	24	B1
CIAA	International Conference on Implementation and Application of Automata	15	B3
CIAED	Congresso Internacional ABED de Educação a Distância	5	B4
CIAIE	Congresso Ibero-Americano de Informática Educativa	4	B4
CIARP	Iberoamerican Congress on Pattern Recognition	16	B2
CIBCB	IEEE Symposium on Computational Intelligence in Bioinformatics and Computational Biology	15	B3
CIBSE	Ibero-American Conference on Software Engineering	6	B4
CIC	International Conference on Communications in Computing	11	B3
CICC	IEEE Custom Integrated Circuits Conference	11	B2
CICLING	Conference on Intelligent Text Processing and Computational Linguistics	29	B1
CIDM	IEEE Symposium on Computational Intelligence and Data Mining	12	B3
CIDR	Biennial Conference on Innovative Data Systems Research	41	A2
CiE	Computability in Europe Conference	16	B2
CIG	IEEE Symposium on Computacional Intelligence and Games	24	B1
CIKM	International Conference on Information and Knowledge Management	85	A1
CIM	Conference on Interdisciplinary Musicology	9	B4
CIMCA	International Conference on Computational Intelligence for Modelling Control and Automation	16	B2
CIMSA	IEEE International Conference on Computational Intelligence for Measurement Systems and Applications	4	B4
CIMSIM	International Conference on Computational Intelligence, Modelling and Simulation	5	B4
CINTED	Ciclo de Palestras Novas Tecnologias na Educação	1	B5
CIRA	IEEE International Symposium on Computational Intelligence in Robotics and Automation	22	B1
CIRAS	International Conference on Computational Intelligence Robotics and Autonomous Systems	4	B4
CIS	International Conference on Computational Intelligence and Security	12	B3
CISched	IEEE Symposium on Computational Intelligence in Scheduling	9	B4
CISIS	International Conference on Complex Intelligent and Software Intensive Systems	15	B3
CISST	International Conference Image Science: Systems and Technology	8	B4
CISTI	Iberian Conference on Information Systems and Technologies	5	B4
CISW	International Conference on Computational Intelligence and Security Workshops	9	B4
CISWSN	Collective Intelligence in Semantic Web and Social Networks	7	B4
CIT	International Conference on Computer and Information Technology	22	B1
CITA	International Conference on IT in Asia	2	B5
CKC	Social and Collaborative Construction of Structured Knowledge	9	B4
CL	Corpus Linguistics Conference	17	B2
CLA	International Conference On Concept Lattices and Their Applications	10	B4
CLAIO	Congreso Latino-Iberoamericano de Investigación Operativa	4	B4
CLEF	Cross Language Evaluation Forum Workshop	16	B2
CLEI	Conferencia Latinoamericana de Informática	8	B4
CLIHC	Latin American Conference on Human-Computer Interaction	3	B5
CLIMA	International Workshop on Computational Logic in Multi-Agent Systems	8	B4
CLIP	Workshop on Cross-Language Information Processing	1	B5
CLOSER	International Conference on Cloud Computing and Services Science	4	B4
CLOUD	IEEE International Conference on Cloud Computing	19	B2
CLOUDCOM	IEEE International Conference on Cloud Computing Technology and Science	19	B2
CLUSTER	Cluster Computing Conference	39	A2
CMC	International Conference on Communications and Mobile Computing	9	B4	3
CMMR	International Symposium on Computer Music Modeling and Retrieval	2	B5
CMV	International Conference on Coordinated and Multiple Views in Exploratory Visualization	17	B2
CNMAC	Congresso Nacional de Matemática Aplicada e Computacional	10	B4
CNSM	International Conference on Network and Services Management	6	B4
CNSR	Annual Conference on Communication Networks and Services Research	17	B2
CoALa	Workshop on Contract Architectures and Languages	3	B5
COCOA	Conference on Combinatorial Optimization and Applications	10	B4
COCOON	International Computing and Combinatorics Conference	28	B1
CODAS	International Symposium on Cooperative Database Systems for Advanced Applications	12	B3
CODASPY	Data and Application Security and Privacy	6	B4
CODES+ISSS	International Conference on Hardware/Software Codesign and System Synthesis	39	A2
CogSci	Annual Conference of the Cognitive Science Society	19	B2
COIN	Workshop on Coordination Organization Institutions and Norms in Agent Systems	6	B4
COLING	International Conference on Computational Linguistics	62	A1
CollaborateCom	International Conference on Collaborative Computing: Networking, Applications and Worksharing	13	B3
CollECTeR	Collaborative Electronic Commerce Technology and Research	10	B4
COLT	Annual Conference on Computational Learning Theory	46	A2
COMMONSENSE	Symposium on Logical Formalizations of Commonsense Reasoning	10	B4
CompLife	International Symposium on Computational Life Science	10	B4
COMPSAC	Annual International Computer Software and Applications Conference	40	A2
CompSysTech	International Conference on Computer Systems and Technologies	14	B3
COMS	Conference on Optimization Methods and Software	39	A2
COMSWARE	ICST International Conference on Communication System software and Middleware	18	B2
CONCUR	International Conference on Concurrency Theory	50	A2
CONEXT	ACM International Conference on Emerging Networking Experiments and Technologies	34	B1
Conf-IRM	International Conference on Information Resources Management	7	B4
CONFENIS	IFIP International Conference on Research and Practical Issues of Enterprise Information Systems	7	B4
CONGRESS	World Congress on Privacy, Security, Trust and the Management of e-Business	1	B5
CoNLL	Conference on Natural Language Learning	22	B1
CONQUEST	Conquest International Conference on Quality Engineering in Software Technology	2	B5
CONTECSI	International Conference on Information Systems and Technology Management	4	B4
COOLCHIPS	IEEE Cool Chips	3	B5
COOP	International Conference on the Design of Cooperative Systems	11	B3
CoopIS	International Conference on Cooperative Information Systems	22	B1
COSIT	Conference on Spatial Information Theory	29	B1
CP	International Conference on Principles and Practice of Constraint Programming	48	A2
CPAIOR	International Conference o Integration of Artificial Intelligence and Operations Research	21	B2
CPM	Annual Symposium on Combinatorial Pattern Matching	33	B1
CRIWG	International Workshop on Groupware	25	B1
CROWNCOM	International Conference on Cognitive Radio Oriented Wireless Networks and Communications	24	B1
CRYPTO	Annual International Cryptology Conference	92	A1
CSB	IEEE Computational Systems Bioinformatics Conference	34	B1
CSC	International Conference on Scientific Computing	5	B4
CSCL	International Conference on Computer-Supported Collaborative Learning	35	B1
CSCLP	ERCIM Annual Workshop on Constraint Solving and Contraint Logic Programming	5	B4
CSCW	ACM Conference on Computer Supported Cooperative Work	78	A1
CSCWD	International Conference on Computer Supported Cooperative Work in Design	18	B2
CSD	Workshop on Critical Systems Development	5	B4
CSE	Conference on Computational Science & Engineering	8	B4
CSEDU	Internation Conference on Computer Supported Education	6	B4
CSEE	International Conference on Computer Science, Environment, Ecoinformatics, and Education	2	B5
CSEE&T	Conference on Software Engineering Education and Training	19	B2
CSFW	IEEE Computer Security Foundations Workshop	57	A1
CSL	Annual Conference on Computer Science Logic	33	B1
CSMR	European Conference on Software Maintenance and Reengineering	40	A2
CSNDSP	International Symposium on Communication Systems, Networks and Digital Signal Processing	11	B3
CSO	International Joint Conference on Computational Sciences and Optimization	3	B5
CSREA_EEE	International Conference on E-Learning, E-Business, Enterprise Information Systems, & E-Government	5	B4
CSSW	Conference on Social Semantic Web	5	B4
CTAC	Computational Techniques and Applications Conference	2	B4
CTC	Workshop Cybercrime and Trustworthy Computing	2	B5
CTW	Cologne-Twente Workshop on graphs and combinatorial optimization	8	B4
CVPR	IEEE Conference on Computer Vision and Pattern Recognition	167	A1
CyberGames	International Conference on Games Research and Development	2	B5
DAARC	Discourse Anaphora and Anaphor Resolution Colloquium	10	B4
DAC	Design Automation Conference	102	A1
DAFX	International Conference on Digital Audio Effects	21	B2
DAIS	IFIP International Conference on Distributed Applications and Interoperable Systems	18	B2
DALT	International Workshop on Declarative Agent Languages and Technologies	10	B4
DARS	International Symposium on Distributed Autonomous Robotic Systems	25	B1
DAS	International Workshop on Document Analysis Systems	22	B1
DASC	IEEE International Symposium on Dependable, Autonomic and Secure Computing	13	B3
DASD	Design Analysis and Simulation of Distributed Systems Symposium	4	B4
DASFAA	International Conference on Database Systems for Advanced Applications	29	B1
DATE	Design, Automation and Test in Europe Conference and Exhibition	79	A1
DaWaK	International Conference on Data Warehousing and Knowledge Discovery	29	B1
DB&IS	International Baltic Conference on Databases and Information Systems	1	B5
DBISP2P	International Workshop on Databases Information Systems and Peer-to-Peer Computing	6	B4
DBKDA	International Conference on Advances in Databases, Knowledge, and Data Applications	5	B4
DBPL	International Symposium on Database Programming	17	B2
DBTA	International Workshop on Database Technology and Applications	5	B4
DCAI	International Conference on Distributed Computing and Artificial Intelligence	6	B4
DCC	Data Compression Conference	45	A2
DCCS	Dependable Computing and Communications Symposium	1	B5
DCW	Workshop on Distributed Communities on the Web	11	B3
DDECS	IEEE Workshop on Design and Diagnostics of Electronic Circuits and Systems	11	B3
DEBS	International Conference on Distributed Event-Based Systems	21	B2
DeLFI	Fachtagung "e-Learning" der Gesellschaft für Informatik	10	B4
DENVECT	IEEE International Workshop on Digital Entertainment, Networked Virtual Environments, and Creative Technology	1	B5
DEON	International Workshop on Deontic Logic in Computer Science	14	B3
DepCoS-RELCOMEX	International Conference on Dependability of Computer Systems	12	B3
DEPEND	International Conference on Dependability	7	B4
DesignCon	Design Conference	13	B3
DEXA	International Conference on Database and Expert Systems Applications	34	B1
DFT	IEEE International Symposium on Defect and Fault Tolerance in VLSI Systems	30	B1
DGCI	Digital Geometry for Computer Imagery	20	B2
DGO	International Conference on Digital Government Research	23	B1
DICTAP	International Conference on Digital Information and Communication Technology and Its Applications	3	B5
DIGITEL	IEEE International Conference on Digital Game and Intelligent Toy Enhanced Learning	11	B3
DIGRA	Digital Games Research Conference	17	B2
DIMVA	GI International Conference on Detection of Intrusions and Malware and Vulnerability Asessment	24	B1
DIPES	IFIP Working Conference on Distributed and Parallel Embedded Systems	12	B3
DIS	Designing Interative Systems Conference	49	A2
DISC	International Symposium on Distributed Computing	40	A2
DIWeb	International Workshop on Data Integration over the Web	8	B4
DL	International Workshop on Description Logics	36	B1
DLT	International Conference on Developments in Language Theory	19	B2
DMDW	Design and Management of Data Warehouses	16	B2
DMO	Data Mining and Optimization	5	B4
DMTCS	International Conference on Discrete Mathematics and Theoretical Computer Science	21	B2
DNA	International Meeting on DNA Computing	10	B4
DNIS	Databases in Networked Information Systems	11	B3
DOA	International Symposium on Distributed Objects and Applications	19	B2
DocEng	ACM Symposium on Document Engineering	32	B1
DOLAP	International Workshop on Data Warehousing and OLAP	31	B1
DRCN	International Workshop on Design of Reliable Communications Networks	20	B2
DRM	ACM Workshop on Digital Rights Management	22	B1
DS	International Conference on Discovery Science	25	B1
DS-RT	IEEE International Symposium on Distributed Simulation and Real Time Applications	20	B2
DSD	EUROMICRO Conference on Digital System Design	27	B1
DSDE	International Conference on Data Storage and Data Engineering	4	B4
DSL	Domain-Specific Languages for Software Engineering Conference	5	B4
DSM	Workshop on Domain-Specific Modeling	12	B3
DSN	International Conference on Dependable Systems and Networks	65	A1
DSOM	IFIP/IEEE International Workshop on Distributed Systems: Operations and Management	24	B1
DSP	International Conference on Digital Signal Processing	37	A2
DSS	IFIP International Conference on Decision Support Systems	4	B4
DSSNS	IEEE Workshop on Dependability and Security in Sensor Networks and Systems	7	B4
DUX	ACM Designing for User Experience Conference	15	B3
DYSPAN	IEEE Symposioum on New Frontiers in Dynamic Spectrum Access Networks	8	B2
E-ACTIVITIES	International Conference on E-Activities	4	B4
e-Learning	IADIS International Conference on e-Learning	7	B4
E-SCIENCE	Brazilian e-Science Workshop	2	B5
E2EMON	IEEE/IFIP Workshop on End-to-End Monitoring Techniques and Services	12	B3
E4MAS	International Workshop on Environments for Multiagent Systems	2	B4
EA	Workshop on Early Aspects	11	B3
EACL	Conference of the European Chapter of the Association for Computational Linguistics	37	A2
EAMT	Annual Conference of the European Association for Machine Translation	8	B3
EANN	International Conference on Engineering Applications of Neural Networks	4	B4
EASE	International Conference on Evaluation and Assessment in Software Engineering	9	B4
EATIS	Euro American Conference on Telematics and Information Systems	9	B4
EC	ACM Conference on Electronic Commerce	58	A1
EC-TEL	European Conference on Technology Enhanced Learning	19	B2
ECAI	European Conference on Artificial Intelligence	49	A2
ECAL	European Conference on Artificial Life	27	B1
ECBS	Annual IEEE International Conference and Workshop on the Engineering of Computer Based Systems	29	B1
ECC	European Control Conference	27	B1
ECCB	European Conference on Computational Biology	34	B1
ECCO	Conference of European Chapter on Combinatorial Optimization	3	B5
ECCTD	European Conference on Circuit Theory and Design	12	B3
ECCV	European Conference on Computer Vision	95	A1
ECIR	European Conference on Information Retrieval	39	A2
ECIS	European Conference on Information Systems	33	B1
ECKM	European Conference on Knowledge Management	7	B4
ECMDA	European Conference on Model Driven Architecture Foundations and Applications	25	B1
ECML	European Conference on Machine Learning	47	A2
ECOOP	European Conference on Object-oriented Programming	61	A1
ECOWS	IEEE European Conference on Web Services	27	B1
ECRTS	Euromicro Conference on Real-Time Systems	47	A2
ECSA	European Conference on Software Architecture	15	B3
ECSCW	European Conference on Computer Supported Cooperative Work	27	B1
ECSQARU	European Conference on Symbolic and Quantitative Approaches to Reasoning with Uncertainty	25	B1
ECWeb	International Conference on Electronic Commerce and Web Technology	27	B1
EC_A	IADIS International Conference e-Commerce	6	B4
ED-MEDIA	World Conference on Educational Multimedia Hypermedia and Telecommunications	14	B3
EDBT	International Conference on Extending Database Technology	52	A2
EDCC	European Dependable Computing Conference	17	B2
EDM	International Conference on Educational Data Mining	13	B3
EDOC	IEEE International Enterprise Distributed Object Computing Conference	42	A2
EDOCW	IEEE International Enterprise Distributed Object Computing Conference Workshops	13	B3
EDUCON	IEEE Engineering Education Conference	7	B4
Edutainment	International Conference on E-learning and Games	14	B3
EEE	IEEE International Conference on e-Technology e-Commerce and e- Service	24	B1
EGC	European Grid Conference	21	B2
EGSR	Eurographics Symposium on Rendering	34	B1
EGVE	Eurographics Workshop on Virtual Environments	10	B4
EICS	The ACM SIGCHI Symposium on Engineering Interactive Computing Systems	30	B1
EISWT	International Conference on Enterprise Information Systems and Web Technologies	4	B4
EIT	IEEE International Conference on Electro/Information Technology	6	B4
EJC	European-Japanese Conference on Information Modelling and Knowledge Bases	4	B4
EKAW	International Conference on Knowledge Engineering and Knowledge Management	33	B1
EKNOW	International Conference on Information, Process, and Knowledge Management	5	B4
ELAVIO	Latin American Operations Research Summer School	2	B5
ELC	Encontro de Linguística de Corpus	2	B5
ELearn	World Conference on E-Learning in Corporate, Government, Healthcare & Higher Education	15	B3
ELML	International Conference on Mobile, Hybrid, and On-line Learning	5	B4	5
EMBC	International Conference of the IEEE Engineering in Medicine and Biology Society	26	B1
EMicro	South Microelectronics School	2	B5
EMMSAD	Exploring Modelling Methods in Systems Analysis and Design	7	B4
Emnets	Workshop on Embedded Networked Sensors	16	B2
EMNLP	Conference on Empirical Methods in Natural Language Processing	72	A1
EMO	International Conference on Evolutionary Multi-Criterion Optimization	40	A2
EMS	EMS Network Conference	1	B5
EMSOFT	ACM Conference on Embedded Software	42	A2
ENADI	Encontro de Administração da Informação	3	B5
ENASE	International Conference on Evaluation of Novel Approaches to Software Engineering	7	B4
Engopt	International Conference on Engineering Optimization	5	B4
ENIA	Encontro Nacional de Intelig	8	B4
ENLG	European Workshop on Natural Language Generation	4	B4
ENRI	Encontro de Robótica Inteligente	5	B4
ENTER	International Conference on Information and Communication Technologies in Tourism	17	B2
EOMAS	Enterprise and Organizational Modeling and Simulation	3	B5
EON	Workshop on Evaluation of Ontology-based Tools	12	B3
ePart	International Conference on Electronic Participation	6	B4
EPIA	Portuguese Conference on Artiificial Intelligence/Encontro Português de Inteligência Artificial	19	B2
EPIO	Escuela de Perfeccionamiento en Investigación Operativa	1	B5
EpiRob	International Conference on Epigenetic Robotics	6	B4
ER	International Conference on Conceptual Modeling	42	A2
ERAD	Escola Regional de Alto Desempenho	1	B5
ERSA	International Conference on Engineering of Reconfigurable Systems and Algorithms	15	B3
ESA	European Symposium on Algorithms	46	A2
ESAIR	Exploiting Semantic Annotations in Information Retrieval	4	B4
ESANN	European Symposium on Artificial Neural Networks	27	B1
ESAW	International Workshop on Engineering Societies in the Agents World	13	B3
eScience	IEEE International Conference on e-science and Grid Computing	22	B1
ESEC/FSE	European Software Engineering Conference and the ACM SIGSOFT Symposium on the Foundations of Software Engineering	49	A2
ESELAW	Experimental Software Engineering Latin American Workshop	4	B4
ESEM	International Symposium on Empirical Software Engineering and Measurement	44	A2
ESM	European Simulation Multiconference	16	B2
ESOP	European Symposium on Programming ETAPS)	53	A2
ESORICS	European Symposium on Research in Computer Security	45	A2
ESS	European Simulation Symposium	12	B3
ESSCIRC	European Solid-State Circuits Conference	33	B1
ESSDERC	European Solid-State Device Research Conference	12	B3
ESTIMedia	IEEE Workshop on Embedded Systems for Real-Time Multimedia	13	B3
ESWC	European Semantic Web Conference	57	A1
ETCS	IEEE International Workshop on Education Technology and Computer Science	8	B4
ETELEMED	International Conference on eHealth, Telemedicine, and Social Medicine	7	B4
ETFA	IEEE International Conference on Emerging Technologies and Factory Automation	26	B1
ETHICOMP	International Conference on the Social and Ethical Impacts of Information and Communication Technologies	6	B4
ETRA	Eye Tracking Research and Applications	3	B5
ETS	IEEE European Test Symposium	18	B2
EUC	IFIP International Conference on Embedded and Ubiquitous Computing	20	B2
EUMAS	European Workshop on Multi-Agent Systems	14	B3
EURO	European Conference on Operational Research	4	B4
Euro-Par	European Conference on Parallel Computing	43	A2
Euro-Plop	European Conference on Pattern Languages of Programs	16	B2
EuroBot	European Workshop on Advanced Mobile Robots	3	B3
EUROCAST	International Workshop on Computer Aided Systems Theory	13	B3
EuroCG	European Workshop on Computational Geometry	10	B4
EUROCOMB	European Conference on Combinatorics Graph Theory and Applications	1	B5
EUROCON	The International Conference on "Computer as a Tool"	12	B3
EuroCrypt	International Conference on the Theory and Application of Cryptographic Techniques	97	A1
EuroGP	European Conference on Genetic Programming	35	B1
EUROGRAPHICS	Eurographics Annual Conference of the European Association for Computer Graphics	5	A2
EuroIMSA	IASTED International Conference on Internet and Multimedia Systems and Applications	9	B4
EuroITV	European Interactive TV Conference	14	B3
EuroMPI	European MPI Users Group Conference	27	B1
EUROPKI	European Public Key Infrastructure Workshop	16	B2
EUROPT	Workshop on Advances in Continuous Optimization	2	B5
EuroSPI	European Conference on Software Process Improvement	20	B2
EuroSys	European Conference on Computer Systems	47	A2
EuroVis	Eurographics/IEEE-VGTC Symposium on Visualization	23	B1
EUSIPCO	European Signal Processing Conference	23	B1
Evoapplications	European Conference on the Applications of Evolutionary Computation	2	B5
Evobio	European Conference on Evolutionary Computation, Machine Learning and Data Mining in Computational Biology	11	B3
EvoCOP	European Conference on Evolutionary Computation in Combinatorial Optimization	20	B2
EWME	European Workshop on Microelectronics Education	5	B4
EWSN	European conference on Wireless Sensor Networks	37	A2
FAABS	IEEE Workshop on Formal Approaches to Agent-Based Systems	18	B2
FASE	Fundamental Approaches to Software Engineering	42	A2
FAST	USENIX Conference on File and Storage Technologies	55	A1
FC	Financial Cryptography	36	B1
FCCM	IEEE Symposium on Field-Programmable Custom Computing Machines	46	A2
FCS	International Conference on Foundations of Computer Science	5	B4
FCT	International Symposium on Fundamentals of Computation Theory	18	B2
FDG	Foundations of Digital Games	11	B3
FDL	Forum on Specification and Design Languages	15	B3
FDTC	Workshop on Fault Diagnosis and Tolerance in Cryptography	17	B2
FECS	International Conference on Frontiers in Education: Computer Science and Computer Engineering	5	B4
FedCSIS	Federated Conference on Computer Science and Information Systems	3	B5
FEF	The Finite Elements in Flow Problems Conference	2	B5
FG	International Conference on Automatic Face and Gesture Recognition	70	A1
FGCN	International Conference on Future Generation Communication and Networking	13	B3
FGIT	Future Generation Information Technology	5	B4
FIE	IEEE Frontiers in Education Conference	24	B1
FIND	Dynamic Taxonomies and Faceted Search	1	B5
FINTDI	Promotion and Innovation with New Technologies in Engineering Education	1	B5
FIT	Frontiers of Information Technology	5	B4
FLAIRS	Florida Artificial Intelligence Research Society	25	B1
FLINS	International FLINS Conference on Uncertainty Modeling in Knowledge Engineering and Decision Making	7	B4
FLOPS	International Symposium on Functional and Logic Programming	22	B1
FM	International Symposium on Formal Methods	35	B1
FMCAD	Formal Methods in Computer Aided Design	33	B1
FMICS	International Workshop on Formal Methods for Industrial Critical Systems	9	B4
FMN	Future Multimedia Networking	4	B4
FMOODS	International Conference on Formal Methods for Open Object-Based Distributed Systems	28	B1
FOAL	Foundations of Aspect-Oriented Languages Workshop	18	B2
FOCI	IEEE Symposium on Foundations of Computational Intelligence	15	B3
FOCS	IEEE Symposium on Foundations of Computer Science	94	A1
FOGA	Foundations of Genetic Algorithms	13	B3
FoIKS	International Symposium on Foundations on Information and Knowledge Systems	18	B2
FOIS	International Conference on Formal Ontology in Information Systems	25	B1
FOMI	Formal Ontologies Meet Industry	6	B4
FOOL	International Workshop on Foundations of Object-Oriented Languages	7	B3
FORMATS	International Conference on Formal Modelling and Analysis of Timed Systems	22	B1
FORTE	IFIP WG 6.1 International Conference on Formal Methods for Networked and Distributed Systems	29	B1
FOSSACS	Foundations of Software Science and Computation Structures Conference	37	A2
FPGA	ACM/SIGDA International Symposium on Field-Programmable Gate Arrays	53	A2
FPL	International Conference on Field-Programmable Logic and Applications	50	A2
FPSAC	International Conference on Formal Power Series and Algebraic Combinatorics	9	B4
FQAS	International Conference on Flexible Query Answering Systems	17	B2
FroCoS	International Symposium on Frontiers of Combining Systems	1	B3
FSE	Fast Software Encryption Workshop	46	A2
FSE_A	ACM SIGSOFT Conference on the Foundations of Software Engineering	59	A1
FSKD	International Conference on Fuzzy Systems and Knowledge Discovery	18	B2
FSR	International Symposium on Field and Service Robotics	4	B4
FSTTCS	IARCS Conference on Foundations of Software Technology and Theoretical Computer Science	33	B1
FTFC	IEEE Faible Tension Faible Consommation	2	B5
FTJP	Workshop on Formal Techniques for Java Programs	8	B4
FTP	International Workshops on First-Order Theorem Proving	5	B4
FTRTFT	Formal Techniques in Real-Time and Fault Tolerant Systems	20	B2
FUSION	International Conference on Information Fusion	25	B1
FUZZ	IEEE International Conference on Fuzzy Systems	38	A2
GADA	International Conference on Grid computing High-performance and Distributed Applications	1	B5
GAME-ON	European GAME-ON Conference	9	B3
GCA	International Conference on Grid Computing and Applications	8	B4
GCC	International Conference on Grid and Cooperative Computing	18	B2
GD	International Symposium on Graph Drawing	18	B2
GDC	Game Developers Conference	22	B1
GECCO	Genetic and Evolutionary Computation Conference	66	A1
GECON	Grid Economics and Business Models	12	B3
GEFS	International Workshop on Genetic and Evolving Fuzzy Systems	7	B4
GENSIPS	IEEE International Workshop on Genomic Signal Processing and Statistics	8	B4
GeoComp	International Conference on GeoComputation	13	B3
GeoInfo	Simpósio Brasileiro de Geoinformática	14	B3
GEOPROCESSING	International Conference on Advanced Geographic Information Systems, Applications, and Services	4	B4
GeoS	International Conference on Geospatial Semantics	14	B3
GI	Graphics Interface	51	A2
GIIS	IEEE International Global Information Infrastructure Symposium	8	B4
GIR	Workshop on Geographic Information Retrieval	19	B2
GIS	International Symposium on Advances in Geographic Information Systems	33	B1
GIScience	International Conference on Geographic Information Science	23	B1
Globe	Conference on Data Management in Grid and P2P Systems	5	B4
GLOBECOM	IEEE Global Telecommunications Conference	90	A1
GLSVLSI	ACM Great Lakes Symposium on VLSI	28	B1
GMP	Geometry Modeling and Processing Conference	18	B2
GOW	Global Optimization Workshop	2	B5
GPC	Advances in Grid and Pervasive Computing	12	B3
GPCE	International Conference on Generative Programming and Component Engineering	37	A2
GRAPP	International Conference on Computer Graphics Theory and Applications	9	B4
GREC	IAPR International Workshop on Graphics Recognition	1	B3
GREENCOM	Green Computing and Communications	6	B4
GREENCOM-CPSCOM	IEEE-ACM International Conference on Green Computing and Communications and International Conference on Cyber Physical and Social Computing	6	B4
GRID	IEEE/ACM International Conference on Grid Computing	46	A2
GROUP	International Conference on Supporting Group Work	45	A2
GSD	International Workshop on Global Software Development for the Practitioner	14	B3
GSDI	International Conference for Global Spatial Data Infrastructure	9	B4
GWC	International Global Wordnet Conference	14	B3
HAIS	International Conference on Hybrid Artificial Intelligence Systems	9	B4
HAPTICS	International Symposium on Haptic Interfaces for Virtual Environment and Teleoperator Systems	28	B1
HASE	IEEE International Symposium on High Assurance Systems Engineering	22	B1
HASKELL	Haskell Workshop	22	B1
HC	Humans and Computers	3	B5
HCII	International Conference on Human-Computer Interaction	17	B2
HCS	IEEE Hot Chips Symposium	7	B4
HealthCom	International Workshop on Enterprise Networking and Computing in Health Care Industry	10	B4
HEALTHINF	International Conference on Health Informatics	7	B4
HIC	Health Informatics Conference	8	B4
HICSS	Annual Hawaii International Conference on System Sciences	97	A1
HIKM	Healthcare Information and Knowledge Management	6	B4
HiPC	International Conference on High Performance Computing	25	B1
HiPEAC	International Conference on High-Performance and Embedded Architectures and Compilers	17	B2
HIPS	International Workshop on High-Level Programming Models and Supportive Environments	10	B4
HIS	International Conference on Hybrid Intelligent Systems	18	B2
HLDVT	IEEE International High Level Design Validation and Test Workshop	6	B3
HLT	Human Language Technology Conference	78	A1
HM	International Workshop on Hybrid Metaheuristics	15	B3
HoloMAS	Holonic and Multi-Agent Systems for Manufacturing	17	B2
HOPL	History of Programming Languages Conference	2	B5
HOST	Hardware-Oriented Security and Trust HOST), IEEE International Workshop on	14	B3
Hot-P2P	International Workshop on Hot Topics in Peer-to-Peer Systems	8	B4	7
HOTI	IEEE Symposium on High-Performance Interconnects	23	B1
HotInterconnect	Symposium on High-Performance Interconnects	21	B2
HotMobile	Workshop on Mobile Computing Systems and Applications	18	B2
HOTNETS	Workshop on Hot Topics in Networks	15	B3
HotOS	USENIX Workshop on Hot Topics in Operating Systems	44	A2
HPCA	International Symposium on High-Performance Computer Architecture	73	A1
HPCN	International Conference on High Performance Computing and Networking	14	B3
HPCS	International Symposium on High Performance Computing Systems and Applications	15	B3
HPDC	IEEE International Symposium on High Performance Distributed Computing	62	A1
HRI	IEEE/ACM International Conference on Human Robot Interaction	38	A2
Humanoids	IEEE RAS International Conference on Humanoids Robots	17	B2
HVC	International Haifa Verification Conference	5	B4
Hypertext	ACM Conference on Hypertext and Hypermedia	45	A2
I	IADIS International Conference Informatics	3	B5
I&CPS	IEEE Industrial and Commercial Power Systems Technical Conference - Conference Record	10	B4
I-KNOW	International Conference on Knowledge Management and Knowledge Technologies	3	B5
I-SEMANTICS	International Conference on Semantic Systems	11	B3
I-SPAN	International Symposium on Parallel Architectures Algorithms and Networks	22	B1
I2TS	Information and Telecommunication Technologies	6	B4
I3D	ACM Symposium on Interactive 3D Graphics and Games	50	A2
I3E	IFIP Conference on e-Commerce e-Business and e-Government	12	B3
IAAI	Conference on Innovative Applications in Artificial Intelligence	14	B2
IAIM	Annual Conference of the International Academy for Information Management	3	B5
IAIT	International Conference on Advances in Information Technology	3	B5
IAS	IEEE Industry Applications Society Annual Conference	16	B1
IAT	ACM International Conference on Intelligent Agent Technology	25	B1
IAW	Annual IEEE Information Assurance Workshop	34	B1
IAWTIC	International Conference on Intelligent Agents Web Technologies and Internet Commerce	3	B4
IBERAMIA	Ibero-American Artificial Intelligence Conference	16	B2
IBERCHIP	Workshop Iberchip	6	B4
IBICA	International Conference on Innovations in Bio-inspired Computing and Applications	1	B5
IBIMA	International Business Information Management	6	B4
IC3K	International Joint Conference on Knowledge Discovery, Knowledge Engineering and Knowledge Management	8	B4
ICA3PP	International Conference on Algorithms and Architectures for Parallel Processing	10	B3
ICAART	International Conference on Agents and Artificial Intelligence	8	B4
ICAC	IEEE International Conference on Autonomic Computing	43	A2
ICAD	International Conference on Auditory Display	28	B1
ICAI	International Conference on Artificial Intelligence	16	B2
ICAIE	International Conference on Artificial Intelligence and Education	2	B5
ICAIL	International Conference on Artificial Intelligence and Law	26	B1
ICAIS	International Conference on Adaptive and Intelligent Systems	11	B3
ICAISC	International Conference on Artifical Intelligence and Soft Computing	17	B2
ICAL	IEEE International Conference on Automation and Logistics	9	B4
ICALIP	International Conference on Audio, Language and Image Processing	9	B4
ICALP	International Colloquium on Automata Languages and Programming	61	A1
ICALT	IEEE International Conference on Advanced Learning Technologies	35	B1
ICANN	International Conference on Artificial Neural Networks	30	B1
ICAPS	International Conference on Automated Planning and Scheduling	49	A2
ICAR	International Conference on Advanced Robotics	21	B2
ICARCV	International Conference on Control, Automation, Robotics and Vision	23	B1
ICAS	International Conference on Autonomic and Autonomous Systems	17	B2
ICASSP	International Conference on Acoustics, Speech, and Signal Processing	84	A1
ICAT	International Conference on Artificial Reality and Telexistence	14	B3
ICATPN	International Conference on the Application and Theory of Petri Nets	36	B1
ICB	International Conference on Biometrics	21	B2
ICBAKE	International Conference on Biometrics and Kansei Engineering	5	B4
ICBBE	International Conference on Bioinformatics and Biomedical Engineering	10	B4
ICC	IEEE International Conference on Communications	53	A2
ICCABS	IEEE International Conference on Computational Advances in Bio and Medical Sciences	3	B5
ICCAD	International Conference on Computer-Aided Design	75	A1
ICCAS	International Conference on Control Automation and Systems	8	B4
ICCBR	International Conference on Case-Based Reasoning	4	B4
ICCBSS	IEEE International Conference on COTS-Based Software Systems	20	B2
ICCC	International Conference on Computer Communication	7	B4
ICCCAS	International Conference on Communications, Circuits and Systems	10	B4
ICCCN	International Conference on Computer Communications and Networks	34	B1
ICCD	International Conference on Computer Design	41	A2
ICCDCS	International Caribbean Conference on Devices, Circuits and Systems	10	B4
ICCE	International Conference on Computers in Education	18	B2
ICCI	International Conference on Computing and Information	1	B4
ICCIIS	International Conference on Communications and Intelligence Information Security	3	B5
ICCIMA	International Conference on Computational Intelligence and Multimedia Applications	18	B2
ICCI_A	IEEE International Conference on Cognitive Informatics	18	B2
ICCL	IEEE International Conference on Computer Languages	2	B5
ICCMS	International Conference on Computer Modeling and Simulation	6	B4
ICCOPT	International Conference on Continuous Optimization	1	B5
ICCS	International Conference on Computational Science	37	A2
ICCSA	International Conference on Computational Science and its Applications	27	B1
ICCSE	International Conference on Computer Science & Education	6	B4
ICCST	Annual International Carnahan Conference on Security Technology	8	B4
ICCS_A	International Conference on Conceptual Structures	28	B1
ICCTA	International Conference on Computing: Theory and Applications	11	B3
ICCV	IEEE International Conference on Computer Vision	120	A1
ICDAR	IEEE International Conference on Document Analysis and Recognition	48	A2
ICDCIT	International Conference on Distributed Computing and Internet Technology	10	B4
ICDCN	IEEE International Conference on Distributed Computing and Networking	10	B4
ICDCS	IEEE International Conference on Distributed Computing Systems	78	A1
ICDE	IEEE International Conference on Data Engineering	113	A1
ICDE_A	World Conference on Open Learning and Distance Education	2	B5
ICDF	IFIP WG 11.9 International Conference on Digital Forensics	1	B5
ICDIM	International Conference on Digital Information Management	11	B3
ICDL	IEEE International Conference on Development and Learning	15	B3
ICDL-EpiRob	IEEE Conference on Development and Learning and Epigenetic Robotics	19	B2
ICDLE	International Conference on Distance Learning and Education	1	B5
ICDM	IEEE International Conference on Data Mining	77	A1
ICDS	International Conference on Digital Society	11	B3
ICDT	International Conference on Database Theory	27	B1
ICDVRAT	International Conference on Disability, Virtual Reality and Associated Technologies	1	B5
ICE-B	International Conference on e-Business	7	B4
ICEB	International Conference on Electronic Business	6	B4
ICEBE	IEEE International Conference on e-Business Engineering	20	B2
ICEC	International Conference on Electronic Commerce	34	B1
ICECCS	IEEE International Conference on Engineering of Complex Computer Systems	24	B1
ICECE	International Conference on Engineering and Computer Education	5	B4
ICECS	IEEE International Conference on Electronics: Circuits and Systems	24	B1
ICEC_A	IFIP International Conference on Entertainment Computing	3	B5
ICEE	International Conference on Engineering Education	16	B2
ICEIMT	International Confernce on Enterprise Integration and Modelling Technology	7	B4
ICEIS	International Conference on Enterprise Information Systems	24	B1
ICEIT	International Conference on Educational and Information Technology	3	B5
ICELET	International Conference on E-Learning and E-Teaching	2	B5
ICEMT	International Conference on Education and Management Technology	3	B5
ICER	International Computing Education Research Workshop	7	B4
ICETC	International Conference on Education Technology and Computer	6	B4
ICETE	International Conference on E-Business and Telecommunication Networks	5	B4
ICFCA	International Conference on Formal Concept Analysis	20	B2
ICFCSE	International Conference on Future Computer Science and Education	1	B5
ICFEM	International Conference on Formal Engineering Methods	27	B1
ICFP	International Conference on Functional Programming	53	A2
ICGEC	International Conference on Genetic and Evolutionary Computing	3	B5
ICGeS	International Conference on Global E-Security	2	B5
ICGSE	IEEE International Conference on Global Software Engineering	20	B2
ICGT	International Conference on Graph Transformation	25	B1
ICHIT	International Conference on Hybrid Information Technology	16	B2
ICHL	International Conference on Hybrid Learning and Education	6	B4
ICIAM	International Congress on Industrial and Applied Mathematics	3	B4
ICIAP	International Conference on Image Analysis and Processing	25	B1
ICIAS	International Conference on Intelligent and Advanced Systems	9	B4
ICICA	International Conference on Information Computing and Applications	2	B5
ICICS	International Conference on Information and Communication Security	33	B1
ICIDS	International Conference on Interactive Digital Storytelling	13	B3
ICIG	International Conference on Image and Graphics	13	B3
ICINCO	International Conference on Informatics in Control Automation and Robotics	10	B4
ICIP	IEEE International Conference on Image Processing	69	A1
ICIQ	International Conference on Information Quality	22	B1
ICIRA	International Conference on Intelligent Robotics and Applications	8	B4
ICIS	International Conference on Information Systems	47	A2
ICISO	International Conference on Informatics and Semiotics in Organisations	1	B5
ICISS	International Conference on Information Systems Security	13	B3
ICIS_A	IEEE/ACIS International Conference on Computer and Information Science	20	B2
ICIT	IEEE International Conference on Industrial Technology	11	B3
ICITA	International Conference on Information Technology and Applications	18	B2
ICITS	International Conference on Intelligent Tutoring Systems	44	A2
ICIW	International Conference on Internet and Web Applications and Services	15	B3
ICL	International Conference on Interactive Collaborative Learning	2	B5
ICLP	International Conference on Logic Programming	35	B1
ICLS	International Conference of the Learning Sciences	24	B1
ICMA	International Conference on Manufacturing Automation	2	B5
ICMC	International Computer Music Conference	32	B1
ICMCS	IEEE International Conference on Multimedia Computing and Systems	6	B3
ICME	IEEE International Conference on Multimedia and Expo	66	A1
ICMI	International Conference on Multimodal Interfaces	46	A2
ICMIC	International Conference on Modelling, Identification and Control	3	B5
ICML	International Conference on Machine Learning	124	A1
ICMLA	International Conference on Machine Learning and Applications	17	B2
ICMLC	International Conference on Machine Learning and Cybernetics	6	B4
ICMPC	International Conference of Music Perception and Cognition	9	B4
ICMR	ACM International Conference on Multimedia Retrieval	51	A2
ICMSAO	International Conferecen on Modeling, Simulation and Applied Optimization	3	B5
ICMT	International Conference on Model Transformation	17	B2
ICMTS	IEEE International Conference on Microelectronics Test Structures	14	B3
ICN	International Conference on Networking	24	B1
ICNC	International Conference on Natural Computation	5	B4
ICNCC	International Conference on Network Communication and Computer	1	B5
ICNP	IEEE International Conference on Network Protocols	65	A1
ICNS	International conference on Networking and Services	14	B3
ICNSC	IEEE Intl Networking, Sensing and Control	12	B3
ICoFCS	International Conference on Forensic Computer Science	2	B5
ICOIN	International Conference on Information Networking	22	B1
ICOMP	International Conference on Internet Computing	20	B2
ICON	IEEE International Conference on Networks	10	B3
ICONIP	International Conference on Neural Information Processing	23	B1
ICONS	International Conference on Systems	12	B3
ICORD	International Conference on Operational Research for Development	1	B5
ICORE	International Conference on Reputation	4	B4
ICOTA	International Conference on Optimization: Techniques And Applications	3	B5
ICPADS	International Conference on Parallel and Distributed Systems	28	B1
ICPC	IEEE International Conference on Program Comprehension	41	A2
ICPP	International Conference on Parallel Processing	42	A2
ICPR	International Conference on Pattern Recognition	81	A1
ICPS	IEEE/ACS International Conference on Pervasive Services	20	B2
ICRA	IEEE International Conference on Robotics and Automation	116	A1
ICS	ACM International Conference on Supercomputing	52	A2
ICSC	IEEE International Conference on Semantic Computing	21	B2
ICSC_A	International Computer Science Conference	16	B2
ICSE	ACM/IEEE International Conference on Software Engineering	117	A1	9
ICSEA	International Conference on Software Engineering Advances	13	B3
ICSM	IEEE International Conference on Software Maintenance	53	A2
ICSMA	International Conference on Smart Manufacturing Application	7	B4
ICSNC	International Conference on Systems and Networks Communication	13	B3
ICSOB	International Conference on Software Business	3	B5
ICSOC	International Conference on Service Oriented Computing	47	A2
ICSOFT	International Conference on Software and Data Technologies	10	B4
ICSP	International Conference on Stochastic Programming	12	B3
ICSR	IEEE International Conference on Software Reuse	23	B1
ICSSEA	International Conference on Software and Systems Engineering and their Applications	5	B4
ICSSP	International Conference on on Software and Systems Process	3	B5
ICST	International Conference on Software Testing, Verification and Validation	21	B2
ICSTW	IEEE International Conference on Software Testing Verification and Validation Workshop	14	B3
ICT	International Conference on Telecommunications	17	B2
ICTAC	International Colloquium on Theoretical Aspects of Computing	15	B3
ICTAI	IEEE International Conference on Tools with Artificial Intelligence	38	A2
ICTEL	International Conference on Technology-Enhanced Learning	3	B5
ICTERI	International Conference on ICT in Education, Research, and Industrial Applications	1	B5
ICTL	International Conferece on Temporal Logic	3	B5
ICTON	International Conference on Transparent Optical Networks	9	B4
ICTSS	IFIP International Conference on Testing Software and Systems	24	B1
ICUIMC	International Conference on Ubiquitous Information Management and Communication	10	B4
ICUMT	Ultra Modern Telecommunications	10	B4
ICVES	IEEE International Conference on Vehicular Electronics and Safety	8	B4
ICVS	International Conference on Computer Vision Systems	26	B1
ICVS_A	International Conference on Virtual Storytelling	16	B2
ICWE	International Conference on Web Engineering	28	B1
ICWET	International Conference & Workshop on Emerging Trends in Technology	5	B4
ICWI	International Conference WWW/Internet	16	B2
ICWL	International Conference on Web-based Learning	14	B3
ICWMC	International Conference on Wireless and Mobile Communications	14	B3
ICWN	International Conference on Wireless Networks	17	B2
ICWS	IEEE International Conference on Web Services	58	A1
ICWSM	AAAI International Conference on Weblogs and Social Media	26	B1
IDA	International Symposium on Intelligent Data Analysis	21	B2
IDAACS	Intelligent Data Acquisition and Advanced Computing Systems Technology and Applications	9	B4
IDC	International Conference on Interaction Design and Children	16	B2
IDC_A	IEEE Conference on Information Decision and Control	9	B4
IDEAL	International Conference on Intelligent Data Engineering and Automated Learning	20	B2
IDEAS_A	International Database Engineering and Applications Symposium	28	B1
IE	International Conference on Intelligent Environments	5	B4
IECON	Annual Conference of the IEEE Industrial Electronics Society	36	B1
IEEEIS	IEEE Conference On Intelligent Systems	22	B1
IEEEIT	IEEE Symposium on Information Theory	63	A1
IEEERFID	IEEE IEEE International Conference on RFID	12	B3
IESA	International Conference on Interoperability for Enterprise Software and Applications	11	B3
IESS	International Conference on Exploring Services Science	5	B4
IESS_A	International Embedded Systems Symposium	1	B5
IFAC	Triennial Event of International Federation of Automatic Control	12	B2
IFIPAI	IFIP Artificial Intelligence	3	B5
IFL	International Symposium on Implementation and Application of Functional Languages	2	B3
IFM	International Conference on Integrated Formal Methods	24	B1
IFSA	International Fuzzy Systems Association World Congress	26	B1
IGARSS	IEEE International Geoscience and Remote Sensing Symposium	14	B1
IGCC	International Green Computing Conference	9	B4
IGIC	IEEE International Games Innovation Conference	1	B5
IGIP	IGIP International Symposium on Engineering Education	4	B4
IH	Information Hiding Workshop	26	B1
IHC	Simpósio Brasileiro sobre Fatores Humanos em Sistemas Computacionais	10	B4
IHI	IHI ACM SIGHIT International Health Informatics Symposium	6	B4
IITSI	International Symposium on Intelligent Information Technology and Security Informatics	5	B4
IIWAS	Information Integration and Web-based Applications and Services	12	B3
IJCAI	International Joint Conference on Artificial Intelligence	90	A1
IJCAR	International Joint Conference on Automated Reasoning	36	B1
IJCBS	International Joint Conference on Bioinformatics, Systems Biology and Intelligent Computing	5	B4
IJCNLP	International Joint Conference on Natural Language Processing	20	B2
IJCNN	IEEE International Joint Conference on Neural Networks	46	A2
IKE	International Conference on Information and Knowledge Engineering	10	B4
ILP	International Conference on Inductive Logic Programming	27	B1
IM	IFIP/IEEE International Symposium on Integrated Network Management	32	B1
IMAGAPP/IVAPP	International Conference on Imaging Theory and Applications and International Conference on Information Visualization Theory and Applications	2	B5
IMC	ACM SIGCOMM Internet Measurement Conference	93	A1
IMCSIT	International Multiconference on Computer Science and Information Technology	10	B4
IMF	International Conference on IT Security Incident Management and IT Forensics	5	B4
IMR	International Meshing Roundtable Conference	28	B1
IMS	Advanced Information Management and Service	4	B4
IMSA	International Conference on Internet and Multimedia Systems and Applications	10	B4
IMS_A	IFAC Workshop on Intelligent Manufacturing Systems	4	B4
INA-OCMC	Interconnection Network Architectures: On-Chip, Multi-Chip	3	B5
INAP	Joint Conference on Application of Declarative Programming and Knowledge Management	7	B4
InCoB	International Conference on Bioinformatics	1	B5
INDIN	IEEE International Conference on Industrial Informatics	12	B3
INDOCRYPT	International Conference on Cryptology in India	30	B1
INEX	International Workshop of the Inititative for the Evaluation of XML Retrieval	8	B4
INFOCOM	Annual Joint Conference of the IEEE Computer and Communications Societies	204	A1
INFORMS	Joint International Meeting	3	B5
INLG	International Natural Language Generation Conference	21	B2
INOC	International Network Optimization Conference	10	B3
InSITE	Informing Science and IT Education Conference	6	B4
INTED	International Technology, Education and Development Conference	4	B4
INTERACT	IFIP TC13 International Conference on Human-Computer Interaction	30	B1
Interspeech	International Conference on Spoken Language Processing	80	A1
IOLTS	IEEE International On-Line Testing Symposium	25	B1
IPAW	International Provenance and Annotation Workshop	20	B2
IPCCC	IEEE International Performance Computing and Communications Conference	24	B1
IPCO	Conference on Integer Programming and Combinatorial Optimization	26	B1
IPCV	International Conference on Image Processing Computer Vision and Pattern Recognition	10	B4
IPDPS	IEEE International Parallel and Distributed Processing Symposium	73	A1
IPDS	International Computer Performance and Dependability Symposium	7	B4
IPEC	International Symposium on Parameterized and Exact Computation	20	B2
IPMU	International Conference on Information Processing and Management of Uncertainty in Knowledge-Based Systems	16	B2
IPOM	IEEE International Workshop on IP Operations and Management	9	B3
IPPS	International Parallel Processing Symposium	71	A1
IPSN	International Symposium on Information Processing in Sensor Networks	88	A1
IPT	Workshop on Immersive Projection Technology	9	B3
IPTPS	International Workshop on Peer-to-Peer Systems	63	A1
IQIS	Information Quality in Information Systems	15	B3
IR	Research and Development in Information Retrieval	2	B5
IRI	IEEE International Conference on Information Reuse and Integration	21	B2
IRMA	Information Resources Management Association International Conference	6	B4
IROS	IEEE/RJS International Conference on Intelligent Robots and Systems	58	A1
IS	IADIS International Conference Information Systems	4	B4
ISAAC	International Symposium on Algorithms and Computation	27	B1
ISADS	International Symposium on Autonomous Decentralized Systems	25	B1
ISAM	IEEE International Symposium on Assembly and Manufacturing	11	B3
ISBI	IEEE International Symposium on Biomedical Imaging: From Nano to Macro	34	B1
ISBRA	International Symposium on Bioinformatics Research and Applications	11	B3
ISC	Information Security Conference	37	A2
ISCA	ACM International Symposium on Computer Architecture	110	A1
ISCAS	IEEE International Symposium on Circuits and Systems	159	A1
ISCC	IEEE Symposium on Computers and Communications	43	A2
ISCIS	International Symposium on Computer and Information Sciences	18	B2
ISCO	International Symposium on Combinatorial Optimization	3	B5
ISCRAM	Intelligent Human Computer Systems for Crisis Response and Management	9	B4
ISC_A	International Supercomputing Conference	2	B5
ISD	International Conference on Information Systems Development	3	B4
ISDA	International Conference on Intelligent Systems Design and Applications	16	B2
ISDPE	International Symposium on Data, Privacy and E-commerce	7	B4
ISECON	Information Systems Education Conference	6	B4
ISECS	International Symposium Electronic Commerce and Security	10	B4
ISER	International Symposium on Experimental Robotics	7	B3
ISI	IEEE Intelligence and Security Informatics	27	B1
ISIC	IEEE International Symposium on Intelligent Control	15	B3
ISICA	International Symposium on Intelligence Computation and Applications	9	B4
ISIE	IEEE International Symposium on Industrial Electronics	32	B1
ISIMP	International Symposium on Intelligent Multimedia Video and Speech Processing	16	B2
ISIPTA	International Symposium on Imprecise Probabilities: Theories and Applications	21	B2
ISIT	IEEE International Symposium on Information Theory	31	B1
ISITA	IEEE International Symposium on Information Theory and Its Applications	14	B3
ISLPED	International Symposium on Low Power Electronics and Design	66	A1
ISM	IEEE International Symposium on Multimedia	19	B2
ISMAR	International Symposium on Mixed and Augmented Reality	48	A2
ISMB	Intelligent Systems in Molecular Biology	91	A1
ISMIR	International Conference on Music Information Retrieval	61	A1
ISMIS	International Syposium on Methodologies for Intelligent Systems	21	B2
ISMM	International Symposium on Mathematical Morphology	25	B1
ISMM_A	International Symposium on Memory Management	25	B1
ISMP	International Symposium on Mathematical Programming	4	B4
ISMVL	IEEE International Symposium on Multiple-Valued Logic	21	B2
ISoLA	International Symposium on Leveraging Applications of Formal Methods, Verification and Validation	7	B4
ISORC	IEEE International Symposium on Object-Oriented Real-Time Distributed Computing	33	B1
ISPA	International Symposium on Parallel and Distributed Processing and Applications	13	B3
ISPASS	IEEE International Symposium on Performance Analysis of Systems and Software	32	B1
ISPD	ACM International Symposium on Physical Design	42	A2
ISPDC	International Symposium on Parallel and Distributed Computing	17	B2
ISQED	IEEE International Symposium on Quality Electronic Design	34	B1
ISRA	International Symposium on Robotics and Automation	24	B1
ISRE	IEEE International Symposium on Requirements Engineering	19	B2
ISRR	International Symposium of Robotics Research	3	B4
ISSADS	IEEE International Symposium and School on Advance Distributed Systems	7	B4
ISSCC	IEEE International Solid-State Circuits Conference	28	B1
ISSCS	International Symposium on Signals Circuits and Systems	12	B3
ISSDQ	International Symposium on Spatial Data Quality	6	B4
ISSPA	IEEE International Symposium on Signal Processing and its Applications	8	B3
ISSRE	IEEE International Symposium on Software Reliability Engineering	41	A2
ISSTA	International Symposium on Software Testing and Analysis	52	A2
IST	IEEE International Workshop on Imaging Systems and Techniques	6	B4
ISTA	International Conference on Information Systems Technology and its Application	11	B3
ISVLSI	IEEE Computer Society Annual Symposium on VLSI	29	B1
ISWC	International Semantic Web Conference	89	A1
ISWC_A	IEEE International Symposium on Wearable Computing	47	A2
ISWPC	Wireless Pervasive Computing	22	B1
ISWSA	International Conference on Intelligent Semantic Web-Services and Applications	2	B5
ITAT	Conference on Theory and Practice of Information Technologies	5	B4
ITBAM	International Conference on Information Technology in Bio- and Medical Informatics	3	B5
ITC	International Test Conference	62	A1
ITEM	Conference on Information Technology in Educational Management	4	B4
ITHE	International Conference on Information Technology Based Higher	5	B4
ITHET	International Conference on Information Technology Based Higher Education and Training	13	B3
ITiCSE	Annual Conference on Integrating Technology into Computer Science Education	35	B1
ITNG	International Conference on Information Technology New Generations	22	B1
ITP	Interactive Theorem Proving continues TPHOL)	10	B4
ITRE	International Conference on Information Technology: Research and Education	16	B2
ITS	International Conference on Interactive Tabletops and Surfaces	17	B2
ITSC	Conference on Intelligent Transportation Systems	25	B1
ITS_A	International Telecommunications Symposium	10	B4
IUI	International Conference on Intelligent User Interfaces	62	A1
IUKM	Integrated Uncertainty in Knowledge Modelling and Decision Making	1	B5
IV	International Conference on Information Visualization	32	B1
IVA	International Conference on Intelligent Virtual Agents	30	B1
IVCNZ	Image and Vision Computing Conference	10	B4
IV_A	Intelligent Vehicles Conference	4	B4
IWANN	International Work-Conference on Artificial and Natural Neural Networks	20	B2
IWCC	IEEE International Workshop on Cluster Computing	8	B4
IWCIA	International Workshop on Combinatorial Image Analysis	10	B4
IWCMC	ACM International Wireless Communications and Mobile Computing Conference	25	B1
IWCS	International Workshop on Computational Semantics	7	B3
IWFHR	International Workshop on Frontiers in Handwriting Recognition	22	B1
IWLS	International Workshop on Logic and Synthesis	19	B2
IWOS	International Workshop on Self-Organizing Systems	10	B4
IWPSE	International Workshop on Principles of Software Evolution	23	B1
IWPT	International Conference on Parsing Technologies	13	B3
IWQoS	International Workshop on Quality of Service	44	A2
IWSCA	IEEE International Workshop on Semantic Computing and Applications	5	B4
IWSM-MENSURA	International Workshop on Software Measurement and the International Conference on Software Process and Product Measurement	7	B4
IWSSIP	International Workshop on Systems Signals and Image Processing	8	B4
JADT	International conference on statistical analysis of textual data	6	B4
JCDL	ACM IEEE Joint Conference on Digital Libraries	53	A2
JCIS	Joint Conference on Information Sciences	18	B2
JDP	Jornada de Descrição do Português	1	B5
JELIA	European Conference on Logics in Artificial Intelligence	30	B1
JIISIC	Jornadas Iberoamericanas de Ingeniería de Software e Ingeniería del Conocimiento	4	B4
JMLC	Joint Modular Languages Conference	13	B3
JSSPP	Workshop on Job Scheduling Strategies for Parallel Processing	32	B1
JTRES	International Workshop on Java Technologies for Real-time and Embedded Systems	12	B3
JURIX	International Conference on Legal Knowledge and Information Systems	12	B3
K-CAP	Knowledge Capture	34	B1
KAMC	Knowledge Acquisition from Multimedia Content	3	B5
KDD	ACM SIGKDD Conference on Knowledge Discovery and Data Mining	133	A1
KES	International Conference on Knowledge-Based and Intelligent Information and Engineering Systems	27	B1
KES-AMSTA	International Conference on Agent and Multi-Agent Systems: Technologies and Applications	13	B3
KR	International Conference on Principles of Knowledge Representation and Reasoning	46	A2
KSEM	International Conference on Knowledge Science, Engineering and Management	11	B3
LA-WASP	Latin American Workshop on Aspect-Oriented Software Development	4	B4
LA-WEB	Latin American Web Congress	19	B2
LACLO	Latin American Conference on Learning Objects	3	B5
LADC	Latin-American Symposium on Dependable Computing	12	B3
LAGOS	Latin-American Algorithms Graphs and Optimization Symposium	4	B4
LANC	Latin America Networking Conference	6	B4
LANMAN	IEEE Workshop on Local and Metropolitan Area Networks	17	B2
LANOMS	Latin American Network Operations and Management Symposium	7	B4
LARS	IEEE Latin American Robotics Symposium	8	B4
LASCAS	IEEE Latin American Symposium on Circuits and Systems - LASCAS	2	B5
LATA	Language and Automata Theory and Applications	12	B3
LaTeCH	Workshop on Language Technology for Cultural Heritage, Social Sciences, and Humanities	1	B5
LATIN	Latin American Symposium on Theoretical Informatics	26	B1
LATINCOM	IEEE Latin-american Conference on Communications	5	B4
Latincrypt	International Conference on Cryptology and Information Security in Latin	5	B4
LATINTCS	Latin American Theoretical Informatics Symposium	25	B1
LATW	IEEE Latin American Test Workshop	8	B4
LAW	The Linguistic Annotation Workshop	13	B3
LCN	IEEE Conference on Local Computer Networks	48	A2
LCPC	International Workshop on Languages and Compilers for Parallel Computing	9	B4
LCTES	ACM SIGPLAN/SIGBED Conference on Languages, Compilers, Tools and Theory for Embedded Systems	34	B1
LDTA	Language Descriptions Tools and Applications	7	B4
LFCS	Symposium on Logical Foundations of Computer Science	12	B3
LICS	IEEE Symposium on Logic in Computer Science	52	A2
LIGHTSEC	Workshop on Lightweight Security and Privacy: Devices, Protocols, and Applications	3	B5
LINZ	Linz Seminar on Fuzzy Set Theory	6	B4
LION	Learning and Intelligent Optimization	9	B4
LoCA	International Symposium on Location- and Context-Awareness	21	B2
LocWeb	International Workshop on Location and the Web	8	B4
LOPSTR	International Symposium on Logic-based Program Synthesis and Transformation	2	B3
LPAR	Logic Programming and Automated Reasoning	32	B1
LPNMR	International Conference on Logic Programming and Non-monotonic Reasoning	30	B1
LREC	International Conference on Language Resources and Evaluation	49	A2
LSFA	Workshop on Logical and Semantic Frameworks, with Applications	5	B4
m-ICTE	International Conference on Multimedia and ICT in Education	2	B5
M4M	Methods for Modalities	5	B4
MABS	International Workshop on Multi-Agent-Based Simulation	11	B3
MASCOTS	IEEE International Symposium on Modeling Analysis and Simulation of Computer and Telecommunication Systems	42	A2
MASS	IEEE International Conference on Mobile Ad-hoc and Sensor Systems	35	B1
MATA	International Workshop on Mobility Aware Technologies and Applications	17	B2
MATES	German Conference on Multiagent System Technologies	17	B2
Matheuristics	International Workshop on Model-based metaheuristics	5	B4
MCCSIS	IADIS International Conference Web Based Communities and Social Media	2	B5
MCM	International Conference on Mathematics and Computation in Music	4	B4
MCO	International Conference on Modelling, Computation and Optimization in Information Systems and Management Sciences	7	B4
MCS	International Workshop on Multiple Classifier Systems	34	B1
MDA/MDM	International Conference on Mobile Data Access/Management	39	A2
MDAI	Modeling Decisions for Artificial Intelligence	15	B3
MDM	IEEE International Conference on Mobile Data Management	38	A2
Med-Hoc-Net	IEEE IFIP Annual Mediterranean Ad Hoc Networking Workshop	7	B4
MEDINFO	International Health Medical) Informatics Congress	27	B1
MESH	International Conference on Advances in Mesh Networks	5	B4
META	International Conference on Metaheuristics and Nature Inspired Computing	2	B5
METMBS	International Conference on Mathematics and Engineering Techniques in Medicine and Biological Sciences	8	B4
MEWS	International Workshop on Mining for Enhanced Web Search	1	B5
MFCS	International Symposium on Mathematical Foundations of Computer Science	33	B1
MFI	IEEE International Conference on Multisensor Fusion and Integration for Intelligent Systems	16	B2
MFPS	Mathematical Foundations of Programming Semantics	2	B4
MGC	International Workshop on Middleware for Grid Computing	13	B3
MIC	Metaheuristic International Conference	13	B3
MICAI	Mexican International Conference on Artificial Intelligence	19	B2
MICCAI	International Conference on Medical Image Computing and Computer Assisted Intervention	56	A1
MICRO	International Symposium on Microarchitecture	86	A1
Middleware	ACM/IFIP/USENIX International Middleware Conference	49	A2
MINES	International Conference on Multimedia Information Networking and Security	4	B4
MIS	Workshop on Multimedia Information Systems	10	B4
MISTA	Multidisciplinary International Scheduling Conference: Theory and Applications	3	B5
MKM	Mathematical Knowledge Management	20	B2
ML	IADIS International Conference on Mobile Learning	12	B3
MLDM	IAPR International Conference on Machine Learning and Data Mining	19	B2
MLMTA	International Conference on Machine Learning and Applications	9	B4
MLSP	IEEE International Workshop on Machine Learning for Signal Processing	16	B2
MMAR	IEEE IFAC International Conference on Methods and Models in Automation and Robotics	4	B4
MMBIA	IEEE Computer Society Workshops on Mathematical Methods in Biomedical Image Analysis	21	B2
MMCN	ACM/SPIE Multimedia Computing and Networking	9	B3
MMEDIA	International Conference on Advances in Multimedia	6	B4
MMM	International Multi-Media Modelling Conference	22	B1
MMNS	IFIP/IEEE Conference on Management of Multimedia Networks and Services	15	B3
MMSP	International Workshop on Multimedia Signal Processing	12	B2
MMSys	ACM SIGMM Conference on Multimedia Systems	11	B3
MMVR	Annual Medicine Meets Virtual Reality Conference	4	B4
MobiCASE	Mobile Computing, Applications, and Services	5	B4
MOBICOM	ACM International Conference on Mobile Computing and Networking	112	A1
MobiDE	Workshop on Data Engineering for Wireless and Mobile Access	20	B2
MOBIHOC	ACM Symposium of Mobile and Ad-hoc Computing	110	A1
MobileHCI	International Conference on Human-Computer Interaction with Mobile Devices and Services	42	A2
MOBILITY	Mobility Conference	13	B3
MOBIMEDIA	International Conference on Mobile Multimedia Communications	9	B4
Mobiquitous	International Conference on Mobile and Ubiquitous Systems: Networks and Services	32	B1
MobiSys	International Conference on Mobile Systems, Applications, and Services	66	A1
MobiWac	ACM International Workshop on Mobility Management and Wireless Access	15	B3
MODELS	ACM/IEEE International Conference on Model-Driven Engineering Languages and Systems	54	A2
MoDISE-EUS	Model Driven Information Systems Engineering: Enterprise, User and System Models	3	B5
MODSIM	International Congress on Modelling and Simulation	12	B3
MOMPES	IEEE International Workshop on Model Based Methodologies for Pervasive and Embedded Software	9	B4
MoodleMoot	MoodleMoot Brasil	2	B5
MOPTA	Annual Conference on Modeling and Optimization: Theory and Applications	1	B5
MPAC	International Workshop on Middleware for Pervasive and Ad-hoc Computing	14	B3
MPC	International Conference on Mathematics of Program Construction	22	B1
MPOOL	Workshop on Multiparadigm Programming with Object Oriented Languages	3	B5
MS	Multimedia Semantics	8	B4
MSA	International Conference on Multimedia Systems and Applications	1	B5
MSC	IEEE Multi-conference on Systems and Control	3	B5
MSE	International Conference on Microelectronic Systems Education	10	B4
MSN	International Conference on Mobile Ad-hoc and Sensor Networks	14	B3
MSR	International Workshop on Mining Software Repositories	32	B1
MSV	International Conference on Modeling: Simulation and Visualization Methods	6	B4
MSVVEIS	International Workshop on Modelling, Simulation, Verification and Validation of Enterprise Information Systems	7	B4
MSWIM	ACM International Conference on Modeling, Analysis and Simulation of Wireless and Mobile Systems	35	B1
MTAGS	Workshop on Many-Task Computing on Grids and Supercomputers	7	B4
MTSR	International Conference on Metadata and Semantics Research	5	B4
MTSummit	Machine Translation Summit	18	B2
MTV	Microprocessor Test and Verification	11	B3
Multimedia	ACM Multimedia Conference	83	A1
MULTIPROG	Workshop on Programmability Issues for Multi-Core Computers	2	B5
MUM	International Conference on Mobile and Ubiquitous Multimedia	21	B2
MVA	IAPR International Workshop on Machine Vision Applications	15	B3
MWC	IEEE CAS Symposium on Emerging Technologies: Frontiers of Mobile and Wireless Communication	13	B3
MWE	Workshop on Multiword Expressions	14	B3
MWSCAS	IEEE International Midwest Symposium on Circuits and Systems	26	B1
NAACL	North American Chapter of the Association for Computational Linguistics Annual Meeting	73	A1
NAFIPS	North American Fuzzy Information Processing Society International Conference	15	B2
NANO	IEEE Conference on Nanotechnology	7	B4
Nanoarch	IEEE/ACM International Symposium on Nanoscale Architectures	8	B4
NAS	Networking, Architecture, and Storage	10	B4
NCA	IEEE International Symposium on Network Computing and Applications	31	B1
NCIS	International Conference on Network Computing and Information Security	2	B5
NDSS	Usenix Networked and Distributed System Security Symposium	64	A1
Net-Con	IFIP International Conference on Network Control and Engineering for QoS: Security and Mobility	6	B4
NETCOM	International Conference on Networks & Communications	4	B4
NetGames	Workshop on Network and System Support for Games	34	B1
Networking	IFIP International Conference on Networking	31	B1
NEW2AN	Next Generation Teletraffic and Wired/Wireless Advanced Networking	13	B3
NEWCAS	IEEE North-East Workshop on Circuits and Systems	8	B4
NFM	NASA Formal Methods	7	B4
NGITS	International Conference on Next Generation Information Technologies and Systems	7	B4
NIDISC	Workshop on Nature Inspired Distributed Computing	1	B5
NIME	New Interfaces for Music Expression	32	B1
NIPS	Neural Information Processing Systems	88	A1
NLDB	International Conference on Applications of Natural Language to Data Bases	22	B1
NLP-KE	International Conference on Natural Language Processing and Knowledge Engineering	5	B4
NLPCS	International Workshop on Natural Language Processing and Cognitive Science	4	B4
NMR	International Workshop on Non-Monotonic Reasoning	20	B2
NOCARC	International Workshop on Network on Chip Architectures	5	B4
NOCS	International Symposium on Networks-on-Chip	28	B1
NOMS	IEEE/IFIP Network Operations and Management Symposium	37	A2
NORCHIP	The Nordic Microelectronics event	15	B3
NordiCHI	Nordic Conference on Human-computer interaction	35	B1
NOSSDAV	Network and Operating System Support for Digital A/V	41	A2	13
NPAR	Non-Photorealistic Animation and Rendering	39	A2
NPC	IFIP International Conference on Network and Parallel Computing	12	B3
NSDI	Symposium on Networked Systems: Design and Implementation	69	A1
NTMS	New Technologies, Mobility and Security	10	B4
NWeSP	International Conference on Next Generation Web Services Practices	14	B3
NyirCrypt	Central European Conference on Cryptography	2	B5
OASICS	OpenAcess Series in Informatics	3	B5
OASIS	Foundations of Intrusion Tolerant Systems	1	B5
OBI	Ontology-supported Business Intelligence	6	B4
ODBASE	International Conference on Ontologies Databases and Applications of Semantics	5	B3
ODBIS	Ontologies-Based Databases and Information Systems	4	B4
ODP	IFIP International Conference on Open Distributed Processing	1	B3
OKCon	Open Knowledge Conference	2	B5
OL	Ontology Learning	4	B4
OM	Ontology Matching	24	B1
ONISW	Ontologies and Information Systems for the Semantic Web	5	B4
ONTOSE	Ontology, Conceptualization and Epistemology for Information Systems, Software Engineering and Service Science	3	B5
OOIS	International Conference on Object-Oriented Information Systems	16	B2
OOPSLA	ACM SIGPLAN International Conference on Object-Oriented Programming, Systems, Languages, and Applications	76	A1
OPODIS	International Conference on Principles of Distributed Systems	19	B2
OPTIM	Optimization of Electrical and Electronic Equipment	9	B4
OptMAS	Workshop on Optimisation in Multi-Agent Systems	1	B5
OR	International Conference on Operations Research	5	B4
OSDI	Usenix Symposium on Operating Systems Design and Implementation	76	A1
OSS	International Conference on Open Source Systems	16	B2
OWLED	OWLED Workshop on OWL: Experiences and Directions	26	B1
OZCHI	Australasian Computer-Human Interaction Conference	22	B1
P2P	International Conference on Peer-to-Peer Computing	46	A2
PAAMS	International Conference on Practical Applications of Agents and Multiagent Systems	9	B4
PAAP	International Symposium on Parallel Architectures, Algorithms and Programming	3	B5
PACCS	Pacific-Asia Conference on Circuits, Communications and Systems	5	B4
PACIFICVIS	IEEE Pacific Visualization Symposium	11	B3
PACT	International Conference on Parallel Architectures and Compilation Techniques	53	A2
PADL	International Symposium on Practical Aspects of Declarative Languages	30	B1
PADO	Symposium on Programs as Data Objects	10	B4
PADS	ACM/IEEE/SCS Workshop on Parallel and Distributed Simulation	27	B1
PADTAD	Workshop on Parallel and Distributed Systems: Testing, Analysis, and Debugging	14	B3
PAKM	International Conference on Practical Aspects of Knowledge Management	19	B2
PAM	Passive and Active Measurement Conference	40	A2
ParCo	International Conference on Parallel Computing	14	B3
PATAT	International Conference on the Practice and Theory of Automated Timetabling	12	B3
PATMOS	International Workshop on Power and Timing Modeling: Optimization and Simulation	17	B2
PBG	IEEE/Eurographics Symposium on Point-Based Graphics	18	B2
PCNS	SPIE Conference on Performance and Control of Network Systems	2	B5
PCS	International Picture Coding Symposium	25	B1
PDC	Participatory Design Conference	22	B1
PDCAT	International Conference on Parallel and Distributed Computing Applications and Technologies	18	B2
PDCS	International Conference on Parallel and Distributed Computing and Systems	5	B3
PDMC-HIBI	International Workshop on Parallel and Distributed Methods in Verification, International Workshop on High Performance Computational Systems	6	B4
PDP	Euromicro International Conference on Parallel Distributed and network-based Processing	27	B1
PDPTA	International Conference on Parallel and Distributed Processing Techniques and Applications	21	B2
PE-WASUN	ACM International Symposium on Performance Evaluation of Wireless Ad Hoc, Sensor, and Ubiquitous Networks	21	B2
PEPM	Symposium on Partial Evaluation and Program Manipulation	25	B1
PERCOL	Workshop on Pervasive Collaboration and Social Networking	30	B1
PerCom	Annual IEEE International Conference on Pervasive Computing and Communications	54	A2
PEREL	Workshop on Pervasive Learning, Life, and Leisure	23	B1
PERFOMANCE	IFIP International Symposium on Computer Performance Modeling Measurements and Evaluation	10	B4
PERVASIVE	International Conference on Pervasive Computing	48	A2
PETRA	International Conference on Pervasive Technologies Related to Assistive Environments	12	B3
PG	Pacific Conference on Computer Graphics and Applications	40	A2
PhiSE	Philosophical Foundations on Information Systems Engineering	3	B5
PIMRC	IEEE International Symposium on Personal and Indoor Mobile Radio Conference	60	A1
PKAW	Pacific Rim Knowledge Acquisition Workshop	6	B4
PKC	International Conference on Theory and Practice of Public-Key Cryptography	54	A2
PKDD	European Conference on Principles and Practice of Knowledge Discovery in Databases	52	A2
PLC	International Conference on Programming Languages and Compilers	7	B4
PLDI	ACM SIGPLAN conference on Programming Language Design and Implementation	98	A1
PLoP	Pattern Languages of Programs Conference	10	B3
PODC	ACM Symposium on Principles of Distributed Computing	61	A1
PODS	ACM SIGACT-SIGMOD-SIGART Symposium on Principles of Database Systems	69	A1
PoEM	The IFIP WG8.1 Working Conference on the Practice of Enterprise Modelling	7	B4
POLICY	IEEE International Workshop on Policies for Distributed Systems and Networks	39	A2
POPL	ACM SIGPLAN-SIGACT Symposium on Principles of Programming Languages	89	A1
PPDP	International ACM SIGPLAN Symposium on Principles and Practice of Declarative Programming	32	B1
PPoPP	Principles and Practice of Parallel Programming	53	A2
PPSC	SIAM Conference on Parallel Processing for Scientific Computing	6	B4
PPSN	Parallel Problem Solving From Nature	46	A2
PPSWR	Principles and Practice of Semantic Web Reasoning	18	B2
PQCrypto	International Workshop on Post-Quantum Cryptography	11	B3
PRDC	IEEE Pacific Rim International Symposium on Dependable Computing	23	B1
PRIS	International Workshop on Pattern Recognition in Information Systems	13	B3
PRO-VE	IFIP Working Conference on Virtual Enterprises	13	B3
PROFES	International Conference on Product Focused Software Process Improvement	22	B1
ProMAS	International Workshop on Programming Multi-Agent Systems	11	B3
PROPOR	International Conference on Computational Processing of Portuguese	15	B3
PSB	Pacific Symposium on Biocomputing	57	A1
PSC	International Conference on Pervasive Systems and Computing	8	B4
PSIVT	Pacific-Rim Symposium on Image and Video Technology	13	B3
PST	Conference on Privacy, Security and Trust	18	B2
PWC	IFIP International Conference on Personal Wireless Communications	24	B1
QEST	International Conference on Quantitative Evaluation of Systems	27	B1
QoSA	International ACM Sigsoft Conference on the Quality of Software Architectures	2	B5
QSHINE	International Conference on Quality of Service in Heterogeneous Wired/Wireless Networks	17	B2
QSIC	International Quality Software Conference	24	B1
Qsine	International Conference on Quality of Service in Heterogeneous Wired/Wireless Networks	17	B2
QUATIC	International Conference on the Quality of Information and Communications Technology	7	B4
RADECS	Conference on RADIATION EFFECTS on COMPONENTS and SYSTEMS	12	B3
RAID	International Symposium on Recent Advances in Intrusion Detection	53	A2
RANDOM	International Workshop on Randomization and Computation	24	B1
RANLP	Recent Advances in Natural Language Processing	17	B2
RAW	Reconfigurable Architectures Workshop	5	B3
RCIS	International Conference on Research Challenges in Information Science	10	B4
RE	IEEE International Requirements Engineering Conference	55	A1
RECOMB	Annual International Conference on Research in Computational Molecular Biology	54	A2
RECONFIG	International Conference on Reconfigurable Computing and FPGAs	9	B4
ReCoSoC	International Workshop on Reconfigurable Communication-centric Systems-on-Chip	9	B4
RecSys	ACM Recommender Systems Conference	29	B1
REET	Requirements Engineering Education and Training	3	B5
REFSQ	Working Conference on Requirements Engineering: Foundation for Software Quality	15	B3
RFID-TA	RFID-Technologies and Applications	5	B4
RIDE	International Workshop on Research Issues in Data Engineering	24	B1
RO-MAN	IEEE International Symposium on Robot and Human Interactive Communication	22	B1
ROBIO	IEEE International Conference on Robotics and Biomimetics	22	B1
ROBOCOMM	IEEE International Conference on Robot Communication and Coordination	10	B4
RR	International Conference on Web Reasoning and Rule Systems	15	B3
RRS	Rational, Robust and Secure Negotiation Mechanisms in Multi-Agent Systems	4	B4
RSA	RSA Conference	11	B1
RSP	International Workshop on Rapid System Prototyping	20	B2
RSS	Robotics: Science and Systems Conference	39	A2
RST	Reliable Software Technologies	18	B2
RST_A	Workshop A RST e os Estudos do Texto	2	B5
RTA	International Conference on Rewriting Techniques and Applications	33	B1
RTAS	IEEE Real-Time and Embedded Technology and Applications Symposium	42	A2
RTCOMP	International Conference on Real-Time Computing Systems and Applications	26	B1
RTCSA	International Conference on Real-Time and Embedded Computing Systems and Applications	26	B1
RTSS	Real Time Systems Symposium	57	A1
RuleApps	East European Workshop on Rule-Based Applications	3	B5
RULEML	International Conference on Rules and Rule Markup Languages for the Semantic Web	22
B1 S&P	IEEE Symposium on Security and Privacy S&P)	110	A1
SAB	International Conference on Simulation of Adaptive Behavior	16	B2
SAC	ACM Symposium on Applied Computing	61	A1
SACI	International Symposium on Applied Computational Intelligence and Informatics	6	B4
SACMAT	ACM Symposium on Access Control Models and Technologies	55	A1
SAC_A	Selected Areas in Cryptography	21	B2
SAFECOMP	International Conference on Computer Safety: Reliability and Security	22	B1
SAFEProcess	IFAC Symposioum on Fault Detection Supervision and Safety of Technical Processes	14	B3
SAICSIT	Conference of the South African Institute of Computer Scientists and Information Technologists	12	B3
SAINT	International Symposium on Applications and the Internet	32	B1
SAM	International Conference on Security and Management	12	B3
SAME	Semantic Ambient Media Experiences	3	B5
SAMOS	International Conference on Embedded Computer Systems: Architectures, Modeling, and Simulation	16	B2
SAMT	Semantics and Digital Media Technologies	11	B3
Sandbox	ACM SIGGRAPH Sandbox Symposium on Videogames	15	B3
SAPIR	International Workshop on Service Assurance with Partial and Intermittent Resources	4	B4
SARNOFF	IEEE Sarnoff Symposium	15	B3
SAS	International Static Analysis Symposium	48	A2
SASO	IEEE International Conference on Self-Adaptive and Self-Organizing Systems	15	B3
SASP	Symposium on Application Specific Processors	8	B4
SAST	Brazilian Workshop on Systematic and Automated Software Testing	3	B5
SAT	International Conference on Theory and Applications of Satisfiability Testing	32	B1
SAVCBS	Workshop on Specification and Verification of Component-Based Systems	7	B4
SBAC-PAD	International Symposium on Computer Architecture and High Performance	18	B2
SBAI	Simpósio Brasileiro de Automação Inteligente	7	B4
SBCARS	Simpósio Brasileiro de Componentes, Arquiteturas e Reutilização de Software	6	B4
SBCCI	Symposium on Integrated Circuits and Systems Design	24	B1
SBCM	Simpósio Brasileiro de Computação Musical	5	B4
SBCUP	Simpósio Brasileiro de Computação Ubíqua e Pervasiva	2	B5
SBES	Simpósio Brasileiro de Engenharia de Software	16	B2
SBESC	Simpósio Brasileiro de Engenharia de Sistemas Computacionais	6	B4
SBGames	Simpósio Brasileiro de Jogos e Entretenimento Digital	7	B4
SBIA	Brazilian Symposium on Artificial Intelligence	19	B2
SBIE	Simpósio Brasileiro de Informática na Educação	18	B2
SBLP	Simpósio Brasileiro de Linguagens de Programação	13	B3
SBM	Eurographics Workshop on Sketch-Based Interfaces and Modeling	14	B3
SBMF	Simpósio Brasileiro de Métodos Formais	7	B4
SBPO	Simpósio Brasileiro de Pesquisa Operacional	9	B4
SBQS	Simpósio Brasileiro de Qualidade de Software	11	B3
SBRC	Simpósio Brasileiro de Redes de Computadores e Sistemas Distribuídos	16	B2
SBRN	Simpósio Brasileiro de Redes Neurais	14	B3
SBRT	Simpósio Brasileiro de Telecomunicações	6	B4
SBSC	Simpósio Brasileiro de Sistemas Colaborativos	5	B4
SBSE	Simpósio Brasileiro de Sistemas Elétricos	3	B5
SBSEG	Simpósio de Segurança da Informação e Sistemas Computacionais	8	B4
SBSI	Simpósio Brasileiro de Sistemas de Informação	7	B4
SC	ACM/IEEE Conference on High Performance Networking and Computing	76	A1
SCA	ACM SIGGRAPH / Eurographics Symposium on Computer Animation	39	A2
SCAM	IEEE International Workshop on Source Code Analysis and Manipulation	15	B3
SCAN	GAMM / IMACS International Symposion on Scientific Computing Computer Arithmetic and Validated Numerics	7	B4
SCC	IEEE International Conference on Services Computing	33	B1
SCCC	International Conference of the Chilean Computer Science Society	13	B3
SCCI	IEEE Symp. Series on Computational Intelligence	3	B5
SCN	International Conference on Security in Communication Networks	16	B2
SCOPES	International Workshop on Software and Compilers for Embedded Systems	16	B2
SCSC	Summer Computer Simulation Conference	15	B3
SCW	IEEE Workshop on Speech Coding	18	B2
SC_A	International Symposium on Software Composition	21	B2	15
SDKB	International Workshops on Semantics in Data and Knowledge Bases	6	B4
SDM	SIAM International Conference on Data Mining	51	A2
SEA	Symposium on Experimental Algorithms	26	B1
SEAA	Euromicro Conference on Software Engineering and Advanced Applications	31	B1
SEAL	International Conference on Simulated Evolution and Learning	11	B3
SEAMS	International Symposium on Software engineering for adaptive and self-managing systems	12	B3
SEAS	Workshop on Software Engineering for Agent-Oriented Systems	5	B4
SEA_A	Software Engineering and Applications	7	B4
SEBIZ	Applications and Business Aspects of the Semantic Web	2	B5
SEC	IFIP International Information Security Conference	28	B1
SECIII	Social, Ethical and Cognitive Issues on Informatics and ICT	2	B5
SECON	IEEE Conference on Sensor Mesh and Ad Hoc Communications and Networks	30	B1
SECPERU	International Workshop on Security, Privacy and Trust in Pervasive and Ubiquitous Computing	10	B4
SECRYPT	International Conference on Information Security and Cryptology	9	B4
SECURECOMM	Security and Privacy in Communication Networks	25	B1
SECURITY	Usenix Security Symposium	81	A1
SECURWARE	International Conference on Emerging Security Information, Systems, and Technologies	11	B3
SEDE	Software Engineering and Data Engineering	5	B4
SEFM	IEEE International Conference on Software Engineering and Formal Methods	26	B1
SEKE	International Conference on Software Engineering and Knowledge Engineering	35	B1
SELMAS	International Workshop on Software Engineering for Large-Scale Multi- Agent Systems	11	B3
SEMAPRO	International Conference on Advances in Semantic Processing	5	B4
SemDial	Workshop on the Semantics and Pragmatics of Dialogue	3	B5
SemEval	International Workshop on Semantic Evaluations	6	B4
SEMISH	Seminário Integrado de Software e Hardware	9	B4
SemWiki	Semantic Wiki Workshop	14	B3
SENSYS	ACM Conference on Embedded Networked Sensor Systems	86	A1
SERA	ACIS International Conference on Software Engineering Research, Management and Applications	14	B3
SERP	International Conference on Software Engineering Research & Practice	17	B2
SERVICES	IEEE Congress on Services	16	B2
ServiceWave	ServiceWave	9	B4
SESS	Software Engineering for Secure Systems	7	B4
SEW	Annual Software Engineering Workshop	20	B2
SForum	Microelectronics Students Forum	1	B5
SGP	Eurographics Symposium on Geometry Processing	7	B4
SIBGRAPI	Conference on Graphics, Patterns and Images	28	B1
SIES	International Symposium on Industrial Embedded Systems	13	B3
SIGCOMM	ACM Special Interest Group on Data Communications Conference	145	A1
SIGCSE	ACM Technical Symposium on Computer Science Education	53	A2
SIGdial	Workshop on Discourse and Dialogue	15	B2
SIGDOC	ACM International Conference on Design of Communication	24	B1
SIGIR	Annual International ACM SIGIR Conference on Research & Development in Information Retrieval	122	A1
SIGITE	Information Technology Education	15	B3
SIGMETRICS	ACM Conference on Measurement and Modelling of Computing Systems	73	A1
SIGMOD	ACM SIGMOD International Conference on Management of Data Conference	151	A1
SIGSEM	ACL Workshop on Prepositions	2	B4
SIIE	Simpósio Internacional de Informática Educativa	6	B4
SIIT	International Conference on Standardization and Innovation in Information Technology	10	B4
SIN	International Conference on Security of Information and Networks	7	B4
SInT	IEEE International Symposium on Information Theory	60	A1
SIPS	IEEE Workshop on Signal Processing Systems Design and Implementation	15	B3
SIROCCO	Colloquium on Structural Information and Communication Complexity	21	B2
SITE	Society for Information Technology and Teacher Education Conference	10	B4
SLE	International Conference on Software Language Engineering	3	B5
SLS	Engineering Stochastic Local Search Algorithms	9	B4
SLT	IEEE Spoken Language Technology Workshop	16	B2
SMAP	International Workshop on Semantic and Social Media Adaptation and Personalization	9	B4
SMC	IEEE International Conference on Systems Man and Cybernetics	19	B2
SMC_A	Sound and Music Computing Conference	16	B2
SMI	IEEE International Conference on Shape Modeling and Applications	38	A2
SOAS	Self-Organization and Autonomous Systems in Computing and Communications	8	B4
SOC	International Symposium on System-on-Chip	10	B4
SOCASE	International Workshop on Service-Oriented Computing: Agents, Semantics, and Engineering	7	B4
SOCC	IEEE International SOC Conference	20	B2
SoCG	Annual ACM Symposium on Computational Geometry	49	A2
SocialCom	International Conference on Social Computing and its Applications	10	B4
SOCINFO	International Workshop on Social Informatics	4	B4
SOCO	International Conference on Soft Computing Models in Industrial and Environmental Applications	4	B4
SODA	ACM-SIAM Symposium on Discrete Algorithms	85	A1
SOFSEM	Conference on Current Trends in Theory and Practice of Computer Science	22	B1
SOFTCOMM	International Conference on Software Telecommunications and Computer Networks	8	B4
Softvis	Software Visualization	28	B1
SoICT	Symposium on Information and Communication Technology	3	B5
SoMeT	Software Methodologies, Tools and Techniques	10	B4
SOSE	International Symposium on Service-Oriented System Engineering	16	B2
SOSP	ACM Symposium on Operating Systems Principles	71	A1
SOUPS	Symposium On Usable Privacy and Security	29	B1
SPAA	ACM Symposium on Parallel Algorithms and Architectures	46	A2
SPECTS	International Symposium on Performance Evaluation of Computer and Telecommunication Systems	8	B4
SPICE	International Software Process Improvement and Capability Determination Conference	3	B4
SPIRE	Symposium on String Processing and Information Retrieval	33	B1
SPL	Southern Conference on Programmable Logic	6	B4
SPLC	Software Product Line Conference	43	A2
SPW	International Workshop on Security Protocols	5	B4
SQC	Software and Systems Quality Conferences	2	B5
SQM	International Conference on Software Quality Management	7	B4
SRDS	IEEE International Symposium on Reliable Distributed Systems	40	A2
SREIS	Symposium on Requirements Engineering for Information Security	5	B4
SRUTI	Steps to Reducing Unwanted Traffic on the Internet Workshop	8	B4
SSBSE	International Symposium on Search Based Software Engineering	7	B4
SSC	IFAC Conference on System Structure and Control	5	B4
SSDBM	International Conference on Scientific and Statistical Database Management	38	A2
SSI	Symposium on System and Information Security	7	B4
SSIRI	Secure System Integration and Reliability Improvement	7	B4
SSIRI-C	IEEE International Conference on Secure Software Integration and Reliability Improvement Companion	6	B4
SSPR	International Workshop on Structural and Syntactic Pattern Recognition	25	B1
SSR	ACM SIGSOFT Working Conference on Software Reusability	3	B4
SSRR	IEEE International Workshop on Safety, Security, & Rescue Robots	6	B4
SSST	Workshop on Syntax, Semantics and Structure in Statistical Translation	1	B5
SSTD	International Symposium on Spatial and Temporal Databases	33	B1
STACS	International Symposium on Theoretical Aspects of Computer Science	44	A2
STAIRS	Starting Artificial Intelligence Research Symposium	8	B4
STEP	IEEE International Workshop on Software Technology and Engineering Practice	14	B3
STFSSD	Software Technologies for Future Dependable Distributed Systems	4	B4
STIL	Brazilian Symposium in Information and Human Language Technology	5	B4
STOC	ACM Symposium on Theory of Computing	100	A1
Storage	IEEE Symposium on Mass Storage Systems	28	B1
SugarLoafPlop	Latin American Conference on Pattern Languages of Programming	3	B5
SUPER	ACM/IEEE Supercomputing Conference	76	A1
SVR	Symposium on Virtual and Augmented Reality	9	B4
SWAP	Workshop on Semantic Web Applications and Perspectives	13	B3
SWAT	Scandinavian Symposium and Workshops on Algorithm Theory	26	B1
SWEL	Workshop on Ontologies and Social Semantic Web for Intelligent Educational Systems	4	B4
SWWS	Semantic Web and Web Services	38	A2
SYROCO	International IFAC Symposium on Robot Control	11	B3
T4E	International Workshop on Technology for Education	3	B5
TABLEAUX	International Conference on Theorem Proving with Analytic Tableaux and Related Methods	24	B1
TAC	Text Analysis Conference	20	B2
TACAS	International Conference on Tools and Algorithms for the Construction and Analysis of Systems	68	A1
TAG+	International Workhop on Tree Adjoining Grammar and Related Formalisms	3	B4
TALN	Traitement Automatique des Langues Naturelles	7	B4
TAP	Tests and Proofs	12	B3
TaPP	USENIX Workshop on the Theory and Practice of Provenance	4	B4
TARK	Conference on Theoretical Aspects of Rationality and Knowledge	19	B2
TASE	IEEE/IFIP International Symposium on Theoretical Aspects of Software Engineering	11	B3
TAU	IEEE International Workshop on Timing Issues	4	B4
TCC	Theory of Cryptography Conference	47	A2
TCGOV	International Conference on E-Government	9	B4
TCoB	International Workshop on Technologies for Collaborative Business Process Management	2	B5
TCS	IFIP International Conference on Theoetical Computer Science	25	B1
TEAA	International Conference on Trends in Enterprise Application Architecture	5	B4
TEAR	Trends in Enterprise Architecture Research	3	B5
TECHEDUCA	International Conference on Technology Enhanced Learning, Quality of Teaching and Education Reform	4	B4
TEI	Tangible and Embedded Interaction	25	B1
TEL	Technology for Education and Learning	1	B5
TES	International Workshop on Technologies for E-Services	21	B2
TextGraphs	Graph-based Methods for Natural Language Processing	10	B4
TFP	Trends in Functional Programming	6	B3
TIDSE	International Conference on Technology for Interactive Digital Storytelling and Entertainment	18	B2
TIME	International Symposium on Temporal Representation and Reasoning	23	B1
TISE	Taller Internacional de Software Educativo	4	B4
TLCA	Typed Lambda Calculus and Applications	23	B1
TLT	International Workshop on Treebanks and Linguistic Theories	7	B4
TMRA	International Conference on Topic Maps Research and Applications	1	B5
TOOLS	Technology of Object-Oriented Languages and Systems Conferences	27	B1
TPDL	International Conference on Theory and Practice of Digital Libraries	34	B1
TPHOLs	International Conference on Theorem Proving in Higher Order Logics	35	B1
TREC	Text Retrieval Conference	51	A2
TRIDENTCOM	International Conference on Testbeds and Research Infrastructure for the Development of Networks and Communities	22	B1
TRUST	Trust in Agent Societies	8	B4
TSD	International Conference on Text Speech and Dialogue	23	B1
UAI	Conference in Uncertainty in Artifical Intelligence	70	A1
UBICOMM	International Conference on Mobile Ubiquitous Computing, Systems, Services and Technologies	11	B3
UbiComp	International Conference on Ubiquitous Computing	70	A1
UCAS	International Workshop on Unique Chips and Systems	4	B4
UDMS	Urban Data Management Symposium	8	B4
UIC	International Conference on Ubiquitous Intelligence and Computing	17	B2
UIST	ACM Symposium on USer Interface Software and Technology	77	A1
UMAP	International Conference on User Modeling, Adaption and Personalization	35	B1
UNISCON	International United Information Systems Conference	9	B4
URSW	Uncertainty Reasoning for the Semantic Web	10	B4
USENIX	USENIX Annual Technical Conference	67	A1
USITS	USENIX Symposium on Internet Technologies and Systems	31	B1
VAMOS	International Workshop on Variability Modelling of Software-intensive Systems	14	B3
VAST	IEEE Symposium on Visual Analytics Science and Technology	24	B1
VCIP	SPIE International Conference on Visual Communications and Image Processing	31	B1
VDEA	SPIE Conference on Visual Data Exploration and Analysis	2	B5
VECIMS	IEEE International Conference on Virtual Environments Human-Computer Interfaces and Measurement Systems	4	B4
VECPAR	International Meeting on High Performance Computing for Computational Science	10	B4
VG	IEEE International Workshop on Volume Graphics	10	B4
VIIP	International Conference on Visualization: Imaging and Image Processing	11	B3
Virtual	International Workshop on Virtual Rehabilitation	10	B4
Vis	IEEE Visualization Conference	4	B4
VISAPP	International Conference on Computer Vision Theory and Applications	14	B3
VISUAL	International Conference on Visual Information Systems	16	B2
VIZSEC	IEEE Workshops on Visualization for Computer Security	23	B1
VL/HCC	IEEE Symposium on Visual Languages and Human-Centric Computing	25	B1
VLFM	Symposium on Visual Languages and Formal Methods	2	B4
VLSI-DAT	International Symposium on VLSI Design, Automation and Test	9	B4
VLSI-SOC	IFIP International Conference on Very Large Scale Integration	15	B3
VLSID	International Conference on VLSI Design	40	A2
VMCAI	Verification, Model Checking, and Abstract Interpretation	40	A2
VMIL	Workshop on Virtual Machines and Intermediate Languages	7	B4
VNC	IEEE Vehicular Networking Conference	6	B4
VR	IEEE Virtual Reality Conference	40	A2
VRCAI	International Conference on Virtual Reality Continuum and its Applications in Industry	17	B2	17
VRCIA	ACM SIGGRAPH International Conference on Virtual-Reality Continuum and its Applications in Industry	18	B2
VRST	ACM Virtual Reality Software and Technology	32	B1
VS-Games	IEEE Conference in Serious Games and Virtual Worlds	7	B4
VSMM	International Conference on Virtual Systems and MultiMedia	9	B3
VSSN	ACM International Workshop on Video Surveillance and Sensor Networks	20	B2
VTC	IEEE Vehicular Technology Conference	98	A1
VTS	IEEE VLSI Test Symposium	47	A2
W2GIS	International Workshop on Web and Wireless Geographical Information Systems	11	B3
W4A	International Cross-Disciplinary Conference on Web Accessibility	26	B1
WAAMD	Workshop em Algoritmos e Aplicações de Mineração de Dados	4	B4
WABI	Workshop on Algorithms in Bioinformatics	34	B1
WAC	Web as Corpus Workshop	6	B4
WACC	WSEAS Applied Computing Conference	3	B5
WACERTS	Workshop on Architectures for Cooperative Embedded Real-Time Systems	2	B5
WACV	IEEE Workshop on Applications of Computer Vision	33	B1
WADS	Workshop on Algorithms and Data Structures	25	B1
WADS_A	Workshop on Architecting Dependable Systems	24	B1
WAFR	Workshop on the Algorithmic Foundations of Robotics	5	B4
WAIM	Interational Conference on Web Age Information Management	21	B2
WAIS	International Workshop on Artificial Intelligence and Statistics	10	B3
WAMCA	Workshop on Architecture for Multi-Core Applications	1	B5
WAMPS	Workshop anual do MPS.BR pessoal enviou meta-dados separadamente)	2	B5
WAOA	Workshop on Approximation and Online Algorithms	4	B4
WASA	International Conference on Wireless Algorithms Systems and Applications	9	B4
WASSA	Workshop on Computational Approaches to Subjectivity and Sentiment Analysis	1	B5
WBC	Web Based Communities	6	B4
WBE	International Symposium on Web-based Education	1	B5
WBPM	Workshop Brasileiro de Gestão de Processos de Negócio	1	B5
WCAE	Workshop on Computer Architecture Education	6	B4
WCAMA	Workshop de Computação Aplicada à Gestão do Meio Ambiente e Recursos Naturais	1	B5
WCCE	IFIP World Conference on Computers in Education	8	B4
WCCI	IEEE World Congress on Computational Intelligence	8	B4
WCCM	World Congress on Computational Mechanics	11	B3
WCGA	Workshop de Computação em Grade e Aplicações	4	B4
WCGE	Workshop de Computação Aplicada em Governo Eletrônico	1	B5
WCNC	IEEE Wireless and Communications and Networking Conference	34	A2
WCOLDE	ICDE World Conference on Open Learning and Distance Education	4	B4
WCRE	IEEE Working Conference on Reverse Engineering	43	A2
WCSMO	World Congress on Structural and Multidisciplinary Optimization	53	A2
WCW	Web Caching Workshop	9	B3
WD	IFIP Wireless Days	8	B4
WDBC	Worshop Brasileiro de Desenvolvimento Baseado em Componentes	2	B5
WDDD	Workshop on Duplicating, Deconstructing and Debunking	10	B4
WDDDM	Workshop on Dependable Distributed Data Management	7	B4
WDL	Workshop de Bibliotecas Digitais	1	B5
WEAC	Workshop sobre Educação em Arquitetura de Computadores	3	B5
Web3D	International Conference on 3D Web Technology	31	B1
WebDB	International Workshop on the Web and Databases	34	B1
WEBIST	International Conference on Web Information Systems and Technologies	11	B3
WebKDD	Web Mining and Web Usage Analysis	4	B4
WEBMEDIA	Brazilian Symposium on Multimedia and the Web	12	B3
WebNet	World Conference on the WWW and Internet	16	B2
WebPRES	Web Personalization and Recommender Systems	2	B5
WEED	Workshop on Energy-Efficient Design	1	B5
WEI	Workshop sobre Educação em Informática	9	B4
WEIS	Workshop on the Economics of Information Security	26	B1
WER	Workshop de Engenharia de Requisitos	14	B3
WES	International Workshop on Web Services, E-Business, and the Semantic Web	16	B2
WESAAC	Workshop-Escola de Sistemas de Agentes, seus Ambientes e Aplicações	1	B5
WETICE	IEEE International Workshops on Enabling Technologies: Infrastructure for Collaborative Enterprises	33	B1
WFLP	International Workshop on Functional and Constraint) Logic Programming	7	B4
WG	International Workshop on Graph-Theoretic Concepts in Computer Science	25	B1
WGRS	Workshop de Gerência e Operação de Redes e Serviços	3	B5
WI	IEEE/WIC/ACM International Conference on Web Intelligence	39	A2
WICON	International Conference on Wireless Internet	13	B3
WICSA	Working IEEE/IFIP Conference on Software Architecture	32	B1
WIDM	ACM International Workshop on Web Information and Data Management	32	B1
WIE	Workshop sobre Informática na Escola	11	B3
WIM	Workshop de Informática Médica	4	B4
WiMOB	IEEE International Conference on Wireless and Mobile Computing, Networking and Communications	23	B1
WiOpt	International Symposium on Modeling and Optimization in Mobile Ad Hoc and Wireless Networks	24	B1
WIS	International Workshop on Wireless Information Systems	7	B4
WISA	Web Information Systems and Applications Conference	9	B4
WISE	International Conference on Web Information Systems Engineering	35	B1
WISEC	Wireless Network Security	22	B1
WISM	Web Information Systems Modeling	6	B4
WISP	IEEE International Workshop on Intelligent Signal Processing	13	B3
WISTDCS	WOMBAT Workshop on Information Security Threats Data Collection and Sharing	4	B4
WITS	Workshop on Information Technologies and Systems	11	B3
WKDD	International Workshop on Knowledge Discovery and Data Mining	10	B4
WMIS	Workshop on Mobile Information Systems	12	B3
WMT	Workshop on Statistical Machine Translation	3	B5
WMUTE	IEEE Wireless, Mobile and Ubiquitous Technologies in Education	14	B3
WOCC	Annual Wireless and Optical Communications Conference	20	B2
WOCN	IFIP International Conference on Wireless and Optical Communications Networks	19	B2
WoLLIC	Workshop on Logic, Language, Information and Computation	11	B3
WOMSDE	Workshop on Ontologies and Metamodels in Software Engineering WOMSDE)	5	B4
WONS	International Conference on Wireless on Demand Network Systems and Service	9	B4
WORDS	IEEE International Workshop on Object-Oriented Real-Time Dependable Systems	24	B1
WORKS	Workshop on Workflows in Support of Large-Scale Science	9	B4
WorldHAPTICS	Joint EUROHAPTICS Conference and Symposium on Haptics Interfaces for Virtual Environment and Teleoperator Systems	26	B1
WORM	ACM Workshop on Recurring Malcode	36	B1
WoSAR	International Workshop on Software Aging and Rejuvenation	4	B4
WoSIDA	Workshop on Autonomic Distributed Systems	1	B5
WoWMoM	IEEE International Symposium on a World of Wireless, Mobile and Multimedia Networks	6	B3
WP2P	Workshop de Peer-to-Peer	3	B5
WPERFORMANCE	Workshop em Desempenho de Sistemas Computacionais e de Comunicação	3	B5
WRC	Workshop on Reconfigurable Computing	4	B4
WRS	International Workshop on Reduction Strategies in Rewriting and Programming	1	B5
WRT	International Workshop on Refactoring Tools	6	B4
WRVA	Workshop de Realidade Virtual e Aumentada	2	B5
WS-REST	International Workshop on RESTful Design	6	B4
WSC	Winter Simulation Conference	56	A1
WSCAD-SSC	Simpósio em Sistemas Computacionais	4	B4
WSCG	International Conferences in Central Europe on Computer Graphics, Visualization and Computer Vision	30	B1
WSDM	International Conference on Web Search and Data Mining	35	B1
WSE	IEEE International Symposium on Web Systems Evolution	20	B2
WSKS	World Summit on the Knowledge Society	10	B4
WSNA	ACM International Conference on Wireless Sensor Networks and Application	29	B1
WSOM	Workshop on Self-Organizing Maps	9	B4
WSPI	International Workshop on Philosophy and Informatics	5	B4
WSWED	Brazilian Workshop on Semantic Web and Education	1	B5
WTF	Workshop de Testes e Tolerância a Falhas	4	B4
WTI	International Workshop on Web and Text Intelligence	3	B5
WTS	Wireless Telecommunications Symposium	14	B3
WUWNET	International Conference on Underwater Networks	16	B2
WVC	Workshop de Visão computacional	3	B5
WWIC	Wired/Wireless Internet Communications	15	B3
WWW	International World Wide Web Conference	145	A1
X-Meeting	International Conference of the Brazilian Association for Bioinformatics and Computational Biology	8	B4
XP	International Conference on Agile Processes in Software Engineering and eXtreme Programming	20	B2
XSym	International XML Database Symposium	15	B3
